FECHA,<=10M,<=10F,<=10,11-20M,11-20F,11-20,21-30M,21-30F,21-30,31-40M,31-40F,31-40,41-50M,41-50F,41-50,51-60M,51-60F,51-60,61-70M,61-70F,61-70,71-80M,71-80F,71-80,81-90M,81-90F,81-90,>=91M,>=91F,>=91,TotalM,TotalF,Total
2020-03-15,0,0,0,0,0,0,0,0,0,0,0,0,0,0,0,0,0,0,0,0,0,0,0,0,0,0,0,0,0,0,0,0,0
2020-03-16,0,0,0,0,0,0,0,0,0,0,0,0,0,0,0,0,0,0,0,0,0,0,0,0,0,0,0,0,0,0,0,0,0
2020-03-17,0,0,0,0,0,0,0,0,0,0,0,0,0,0,0,0,0,0,0,0,0,1,0,1,0,0,0,0,0,0,1,0,1
2020-03-18,0,0,0,0,0,0,0,0,0,0,0,0,0,0,0,0,0,0,0,0,0,1,0,1,0,0,0,0,0,0,1,0,1
2020-03-19,0,0,0,0,0,0,0,0,0,0,0,0,0,0,0,0,0,0,0,0,0,1,0,1,0,0,0,0,0,0,1,0,1
2020-03-20,0,0,0,0,0,0,0,0,0,0,0,0,0,0,0,0,0,0,0,0,0,1,0,1,0,1,1,0,0,0,1,1,2
2020-03-21,0,0,0,0,0,0,0,0,0,0,0,0,0,0,0,0,0,0,1,0,1,3,0,3,0,1,1,0,0,0,4,1,5
2020-03-22,0,0,0,0,0,0,0,0,0,0,0,0,0,0,0,0,0,0,1,0,1,4,0,4,0,1,1,0,0,0,5,1,6
2020-03-23,0,0,0,0,0,0,0,0,0,0,0,0,0,0,0,0,0,0,1,0,1,4,0,4,0,1,1,0,0,0,5,1,6
2020-03-24,0,0,0,0,0,0,0,0,0,0,0,0,0,0,0,0,0,0,1,0,1,4,1,5,0,1,1,0,0,0,5,2,7
2020-03-25,0,0,0,0,0,0,0,0,0,0,0,0,0,0,0,0,0,0,2,0,2,4,1,5,1,3,4,0,1,1,7,5,12
2020-03-26,0,0,0,0,0,0,0,0,0,0,0,0,0,0,0,1,0,1,4,0,4,4,1,5,1,3,4,0,1,1,10,5,15
2020-03-27,0,0,0,0,0,0,0,0,0,0,0,0,0,0,0,2,0,2,5,0,5,4,1,5,1,3,4,0,1,1,12,5,17
2020-03-28,0,0,0,0,0,0,0,0,0,0,0,0,0,0,0,2,0,2,5,0,5,4,1,5,3,3,6,0,1,1,14,5,19
2020-03-29,0,0,0,0,0,0,0,0,0,0,0,0,0,0,0,2,0,2,5,0,5,4,1,5,3,3,6,0,1,1,14,5,19
2020-03-30,0,0,0,0,0,0,0,0,0,0,0,0,1,0,1,2,0,2,6,0,6,6,1,7,3,3,6,0,2,2,18,6,24
2020-03-31,0,0,0,0,0,0,0,0,0,0,0,0,1,0,1,3,0,3,6,0,6,8,2,10,3,4,7,0,2,2,21,8,29
2020-04-01,0,0,0,0,0,0,0,0,0,0,0,0,1,0,1,3,0,3,8,0,8,8,2,10,3,4,7,0,2,2,23,8,31
2020-04-02,0,0,0,0,0,0,0,0,0,0,0,0,1,0,1,3,0,3,8,0,8,10,2,12,3,4,7,1,3,4,26,9,35
2020-04-03,0,0,0,0,0,0,0,0,0,0,0,0,1,0,1,3,1,4,8,1,9,11,2,13,3,5,8,1,3,4,27,12,39
2020-04-04,0,0,0,0,0,0,0,0,0,0,0,0,1,0,1,3,1,4,8,1,9,11,2,13,3,5,8,2,3,5,28,12,40
2020-04-05,0,0,0,0,0,0,0,0,0,0,0,0,1,1,2,3,1,4,8,1,9,13,2,15,3,5,8,2,3,5,30,13,43
2020-04-06,0,0,0,0,0,0,0,0,0,0,0,0,1,1,2,3,1,4,9,1,10,13,3,16,3,5,8,2,3,5,31,14,45
2020-04-07,0,0,0,0,0,0,0,0,0,0,0,0,1,1,2,3,1,4,9,1,10,13,5,18,3,5,8,3,3,6,32,16,48
2020-04-08,0,0,0,0,0,0,0,0,0,0,0,0,1,1,2,4,1,5,9,1,10,14,6,20,3,5,8,3,3,6,34,17,51
2020-04-09,0,0,0,0,0,0,0,0,0,0,0,0,1,1,2,4,1,5,9,1,10,14,6,20,3,5,8,3,3,6,34,17,51
2020-04-10,0,0,0,0,0,0,0,0,0,0,0,0,1,1,2,4,1,5,9,1,10,14,6,20,3,5,8,3,3,6,34,17,51
2020-04-11,0,0,0,0,0,0,0,0,0,0,0,0,1,1,2,4,1,5,9,1,10,14,6,20,5,5,10,3,3,6,36,17,53
2020-04-12,0,0,0,0,0,0,0,0,0,0,0,0,1,1,2,4,1,5,9,1,10,14,6,20,5,5,10,3,3,6,36,17,53
2020-04-13,0,0,0,0,0,0,0,0,0,0,0,0,1,1,2,4,1,5,9,1,10,14,6,20,5,5,10,3,3,6,36,17,53
2020-04-14,0,0,0,0,0,0,0,0,0,0,0,0,1,1,2,4,1,5,10,1,11,16,7,23,5,5,10,3,3,6,39,18,57
2020-04-15,0,0,0,0,0,0,0,0,0,0,0,0,1,1,2,4,1,5,10,1,11,16,7,23,5,5,10,3,3,6,39,18,57
2020-04-16,0,0,0,0,0,0,0,0,0,0,0,0,1,1,2,4,1,5,10,1,11,16,7,23,5,5,10,3,3,6,39,18,57
2020-04-17,0,0,0,0,0,0,1,0,1,0,0,0,1,1,2,4,1,5,10,1,11,16,8,24,7,8,15,3,4,7,42,23,65
2020-04-18,0,0,0,0,0,0,1,0,1,0,0,0,2,1,3,4,1,5,10,1,11,16,9,25,8,10,18,3,6,9,44,28,72
2020-04-19,0,0,0,0,0,0,1,0,1,0,0,0,2,1,3,4,1,5,10,1,11,16,9,25,8,10,18,4,6,10,45,28,73
2020-04-20,0,0,0,0,0,0,1,0,1,0,0,0,3,1,4,4,1,5,10,1,11,16,9,25,9,10,19,4,7,11,47,29,76
2020-04-21,0,0,0,0,0,0,1,0,1,0,0,0,3,1,4,5,1,6,11,1,12,16,9,25,11,10,21,5,10,15,52,32,84
2020-04-22,0,0,0,0,0,0,1,0,1,1,0,1,3,1,4,5,1,6,12,1,13,17,12,29,12,12,24,6,13,19,57,40,97
2020-04-23,0,0,0,0,0,0,1,0,1,1,0,1,3,1,4,5,1,6,13,2,15,19,14,33,15,12,27,6,16,22,63,46,109
2020-04-24,0,0,0,0,0,0,1,0,1,1,0,1,3,1,4,5,1,6,13,2,15,19,14,33,17,14,31,6,16,22,65,48,113
2020-04-25,0,0,0,0,0,0,1,0,1,1,0,1,4,1,5,5,1,6,13,2,15,19,14,33,17,16,33,6,16,22,66,50,116
2020-04-26,0,0,0,0,0,0,1,0,1,1,0,1,4,1,5,5,1,6,13,2,15,19,14,33,17,16,33,6,16,22,66,50,116
2020-04-27,0,0,0,0,0,0,1,0,1,1,0,1,4,1,5,5,1,6,14,2,16,20,14,34,19,17,36,7,17,24,71,52,123
2020-04-28,0,0,0,0,0,0,1,0,1,1,0,1,4,1,5,5,1,6,14,2,16,20,14,34,20,19,39,7,17,24,72,54,126
2020-04-29,0,0,0,0,0,0,1,0,1,1,0,1,4,1,5,5,1,6,14,2,16,21,14,35,20,19,39,7,17,24,73,54,127
2020-04-30,0,0,0,0,0,0,1,0,1,1,0,1,4,1,5,6,1,7,14,2,16,21,14,35,20,19,39,7,17,24,74,54,128
2020-05-01,0,0,0,0,0,0,1,0,1,1,0,1,4,1,5,7,1,8,14,2,16,21,14,35,20,20,40,8,17,25,76,55,131
2020-05-02,0,0,0,0,0,0,1,0,1,1,0,1,4,1,5,7,1,8,14,2,16,22,14,36,20,20,40,8,17,25,77,55,132
2020-05-03,0,0,0,0,0,0,1,0,1,1,0,1,4,1,5,8,1,9,15,2,17,22,14,36,21,20,41,8,17,25,80,55,135
2020-05-04,0,0,0,0,0,0,1,0,1,1,0,1,4,1,5,9,1,10,15,2,17,22,14,36,21,22,43,8,17,25,81,57,138
2020-05-05,0,0,0,0,0,0,1,0,1,2,0,2,4,2,6,9,1,10,15,2,17,23,14,37,24,22,46,8,19,27,86,60,146
2020-05-06,0,0,0,0,0,0,1,0,1,2,0,2,5,2,7,9,1,10,16,3,19,24,14,38,25,23,48,9,20,29,91,63,154
2020-05-07,0,0,0,0,0,0,1,0,1,2,0,2,5,2,7,11,1,12,16,3,19,24,15,39,26,23,49,9,22,31,94,66,160
2020-05-08,0,0,0,0,0,0,1,0,1,2,0,2,5,2,7,11,1,12,16,3,19,24,15,39,26,24,50,9,22,31,94,67,161
2020-05-09,0,0,0,0,0,0,1,0,1,2,0,2,5,2,7,11,1,12,16,4,20,24,15,39,26,24,50,10,22,32,95,68,163
2020-05-10,0,0,0,0,0,0,1,0,1,2,0,2,5,2,7,11,1,12,17,4,21,24,15,39,26,24,50,10,22,32,96,68,164
2020-05-11,0,0,0,0,0,0,1,0,1,2,0,2,6,3,9,11,1,12,18,4,22,24,15,39,26,24,50,10,22,32,98,69,167
2020-05-12,0,0,0,0,0,0,1,0,1,3,0,3,6,3,9,13,2,15,20,5,25,25,18,43,26,25,51,11,23,34,105,76,181
2020-05-13,0,0,0,0,0,0,1,0,1,4,0,4,6,3,9,13,3,16,22,5,27,25,18,43,26,26,52,11,25,36,108,80,188
2020-05-14,0,0,0,0,0,0,1,0,1,4,0,4,6,3,9,15,3,18,23,5,28,26,19,45,26,27,53,11,25,36,112,82,194
2020-05-15,0,0,0,0,0,0,1,0,1,4,0,4,6,4,10,15,3,18,23,5,28,26,20,46,26,28,54,12,26,38,113,86,199
2020-05-16,0,0,0,0,0,0,1,0,1,5,0,5,6,5,11,16,3,19,23,6,29,28,21,49,26,29,55,12,29,41,117,93,210
2020-05-17,0,1,1,0,0,0,1,0,1,5,0,5,6,6,12,19,3,22,24,6,30,29,21,50,28,32,60,12,29,41,124,98,222
2020-05-18,0,1,1,0,0,0,1,0,1,6,0,6,7,6,13,21,3,24,26,7,33,31,22,53,28,32,60,12,29,41,132,100,232
2020-05-19,0,1,1,0,0,0,1,0,1,6,0,6,8,6,14,22,3,25,26,7,33,31,22,53,28,34,62,13,29,42,135,102,237
2020-05-20,0,1,1,0,0,0,1,1,2,7,0,7,8,7,15,25,4,29,27,7,34,32,23,55,29,36,65,14,29,43,143,108,251
2020-05-21,0,1,1,0,0,0,1,1,2,7,0,7,9,7,16,25,4,29,29,7,36,32,24,56,29,37,66,14,32,46,146,113,259
2020-05-22,0,1,1,0,0,0,1,1,2,7,0,7,9,7,16,28,4,32,30,9,39,32,24,56,29,37,66,14,32,46,150,115,265
2020-05-23,0,1,1,0,0,0,1,1,2,7,0,7,12,7,19,30,4,34,30,9,39,33,24,57,31,41,72,14,33,47,158,120,278
2020-05-24,0,1,1,0,0,0,1,1,2,8,0,8,12,7,19,30,5,35,31,9,40,33,25,58,31,41,72,15,33,48,161,122,283
2020-05-25,0,1,1,0,0,0,1,1,2,8,0,8,12,8,20,31,5,36,32,11,43,34,29,63,32,42,74,16,33,49,166,130,296
2020-05-26,0,1,1,0,0,0,1,1,2,8,0,8,12,8,20,34,7,41,35,12,47,35,30,65,32,45,77,18,33,51,175,137,312
2020-05-27,0,1,1,0,0,0,1,1,2,8,0,8,14,9,23,34,7,41,36,12,48,38,33,71,33,47,80,18,34,52,182,144,326
2020-05-28,0,1,1,0,0,0,1,1,2,10,0,10,14,10,24,36,9,45,37,12,49,39,39,78,37,52,89,21,42,63,195,166,361
2020-05-29,0,1,1,0,0,0,1,1,2,10,0,10,15,11,26,37,9,46,39,12,51,41,41,82,39,58,97,21,45,66,203,178,381
2020-05-30,0,1,1,0,0,0,1,1,2,10,0,10,16,11,27,40,9,49,39,12,51,43,42,85,40,58,98,22,45,67,211,179,390
2020-05-31,0,1,1,0,0,0,1,1,2,10,0,10,17,11,28,41,11,52,39,12,51,47,43,90,43,60,103,23,45,68,221,184,405
2020-06-01,0,1,1,0,0,0,1,1,2,11,0,11,17,12,29,43,11,54,39,12,51,48,45,93,46,62,108,23,45,68,228,189,417
2020-06-02,1,1,2,0,0,0,1,1,2,11,0,11,18,14,32,44,12,56,45,12,57,50,47,97,47,64,111,25,48,73,242,199,441
2020-06-03,1,1,2,0,0,0,1,1,2,11,0,11,19,15,34,47,13,60,50,13,63,53,48,101,48,65,113,25,48,73,255,204,459
2020-06-04,1,1,2,0,0,0,1,1,2,12,0,12,19,15,34,48,14,62,53,14,67,56,50,106,48,68,116,28,52,80,266,215,481
2020-06-05,1,1,2,0,0,0,1,2,3,12,0,12,19,15,34,49,15,64,57,16,73,61,55,116,50,71,121,28,54,82,278,229,507
2020-06-06,1,1,2,0,0,0,1,2,3,12,0,12,19,15,34,52,15,67,57,16,73,64,56,120,51,77,128,29,57,86,286,239,525
2020-06-07,1,1,2,0,0,0,1,2,3,12,0,12,19,15,34,54,15,69,58,16,74,64,58,122,54,82,136,29,59,88,292,248,540
2020-06-08,1,1,2,0,0,0,1,2,3,14,0,14,21,15,36,55,15,70,58,17,75,69,60,129,59,83,142,29,61,90,307,254,561
2020-06-09,1,1,2,0,0,0,1,2,3,15,1,16,21,16,37,57,15,72,58,20,78,71,60,131,61,85,146,29,64,93,314,264,578
2020-06-10,1,1,2,0,0,0,1,2,3,15,1,16,21,17,38,59,16,75,60,21,81,75,61,136,62,93,155,30,67,97,324,279,603
2020-06-11,1,1,2,0,0,0,1,2,3,15,1,16,23,17,40,63,16,79,63,23,86,77,64,141,63,96,159,30,70,100,336,290,626
2020-06-12,1,1,2,0,0,0,1,2,3,16,1,17,23,17,40,68,17,85,64,25,89,84,64,148,66,96,162,31,72,103,354,295,649
2020-06-13,1,1,2,0,0,0,1,3,4,16,1,17,23,19,42,70,18,88,67,25,92,86,68,154,67,100,167,31,77,108,362,312,674
2020-06-14,1,1,2,0,0,0,1,3,4,16,1,17,24,19,43,70,19,89,70,25,95,88,69,157,69,103,172,31,80,111,370,320,690
2020-06-15,1,1,2,0,0,0,1,3,4,16,1,17,24,20,44,70,19,89,73,26,99,88,73,161,69,104,173,34,80,114,376,327,703
2020-06-16,1,1,2,0,0,0,2,3,5,17,1,18,25,20,45,73,19,92,76,29,105,96,75,171,70,106,176,34,83,117,394,337,731
2020-06-17,2,1,3,0,0,0,3,3,6,17,1,18,26,20,46,73,22,95,81,30,111,104,77,181,72,109,181,35,87,122,413,350,763
2020-06-18,2,1,3,0,0,0,3,3,6,19,2,21,28,20,48,77,23,100,83,31,114,105,79,184,77,110,187,36,88,124,430,357,787
2020-06-19,2,1,3,0,0,0,3,3,6,20,2,22,28,20,48,79,25,104,87,35,122,109,83,192,84,111,195,36,96,132,448,376,824
2020-06-20,2,1,3,0,0,0,3,3,6,21,2,23,28,20,48,81,26,107,88,38,126,116,87,203,87,115,202,38,99,137,464,391,855
2020-06-21,2,1,3,0,0,0,3,3,6,21,3,24,29,21,50,82,26,108,92,38,130,118,90,208,89,119,208,38,104,142,474,405,879
2020-06-22,2,1,3,0,0,0,3,4,7,22,3,25,31,21,52,82,27,109,97,42,139,124,94,218,96,125,221,40,105,145,497,422,919
2020-06-23,2,1,3,0,0,0,3,4,7,23,3,26,32,21,53,86,28,114,98,44,142,130,95,225,104,132,236,43,108,151,521,436,957
2020-06-24,2,1,3,0,0,0,3,4,7,23,3,26,32,23,55,88,29,117,101,46,147,134,96,230,110,136,246,44,114,158,537,452,989
2020-06-25,2,1,3,0,0,0,3,4,7,23,3,26,34,24,58,91,29,120,108,50,158,136,99,235,115,144,259,45,118,163,557,472,1029
2020-06-26,2,1,3,0,0,0,3,4,7,23,3,26,34,26,60,94,30,124,110,52,162,142,99,241,117,148,265,46,121,167,571,484,1055
2020-06-27,2,1,3,0,0,0,3,4,7,23,3,26,35,26,61,95,31,126,114,54,168,143,101,244,120,151,271,48,124,172,583,495,1078
2020-06-28,2,1,3,0,0,0,3,4,7,23,3,26,35,26,61,95,31,126,114,55,169,145,103,248,125,156,281,49,130,179,591,509,1100
2020-06-29,2,1,3,0,0,0,3,5,8,23,3,26,35,26,61,97,31,128,117,57,174,149,108,257,135,163,298,50,133,183,611,527,1138
2020-06-30,2,1,3,0,0,0,3,5,8,23,3,26,36,27,63,101,34,135,126,60,186,156,113,269,140,171,311,52,141,193,639,555,1194
2020-07-01,2,1,3,0,0,0,3,5,8,23,3,26,37,28,65,103,35,138,129,60,189,159,115,274,151,175,326,55,144,199,662,566,1228
2020-07-02,2,1,3,0,0,0,3,5,8,23,4,27,38,28,66,106,35,141,135,61,196,165,120,285,155,178,333,55,147,202,682,579,1261
2020-07-03,2,1,3,0,0,0,3,5,8,23,5,28,38,29,67,108,35,143,140,61,201,170,127,297,156,188,344,57,151,208,697,602,1299
2020-07-04,2,1,3,0,1,1,3,5,8,23,6,29,39,30,69,109,36,145,141,63,204,175,134,309,160,199,359,58,159,217,710,634,1344
2020-07-05,2,2,4,0,1,1,3,5,8,23,7,30,39,30,69,112,37,149,145,68,213,177,138,315,164,210,374,61,163,224,726,661,1387
2020-07-06,2,2,4,0,1,1,3,5,8,23,7,30,41,30,71,115,38,153,151,71,222,186,146,332,173,224,397,66,172,238,760,696,1456
2020-07-07,2,2,4,0,1,1,3,5,8,24,7,31,41,30,71,117,38,155,162,72,234,196,153,349,181,231,412,70,178,248,796,717,1513
2020-07-08,2,2,4,0,1,1,3,5,8,24,7,31,42,31,73,119,41,160,168,73,241,203,161,364,186,235,421,74,186,260,821,742,1563
2020-07-09,2,2,4,0,2,2,3,5,8,24,7,31,43,32,75,119,41,160,171,74,245,211,165,376,191,245,436,76,190,266,840,763,1603
2020-07-10,2,2,4,0,2,2,3,6,9,25,7,32,43,32,75,121,44,165,177,77,254,217,173,390,203,254,457,77,195,272,868,792,1660
2020-07-11,2,2,4,0,2,2,3,7,10,27,7,34,43,32,75,122,44,166,182,77,259,221,175,396,205,262,467,78,201,279,883,809,1692
2020-07-12,2,2,4,0,2,2,4,7,11,27,8,35,47,32,79,124,44,168,186,77,263,226,180,406,217,267,484,78,208,286,911,827,1738
2020-07-13,2,2,4,0,2,2,4,7,11,27,8,35,47,33,80,125,46,171,192,78,270,233,189,422,225,272,497,80,219,299,935,856,1791
2020-07-14,2,2,4,0,2,2,4,7,11,27,8,35,48,33,81,127,50,177,199,80,279,249,192,441,228,283,511,85,227,312,969,884,1853
2020-07-15,2,3,5,0,2,2,4,7,11,28,9,37,51,33,84,127,50,177,208,81,289,260,197,457,235,294,529,87,233,320,1002,909,1911
2020-07-16,2,3,5,0,2,2,4,7,11,29,9,38,51,33,84,128,50,178,215,83,298,268,201,469,246,305,551,93,240,333,1036,933,1969
2020-07-17,2,3,5,0,2,2,5,7,12,29,10,39,54,33,87,131,51,182,224,85,309,275,206,481,259,316,575,95,253,348,1074,966,2040
2020-07-18,2,3,5,0,2,2,6,8,14,29,10,39,56,34,90,131,52,183,228,85,313,281,213,494,263,324,587,97,258,355,1093,989,2082
2020-07-19,2,3,5,0,2,2,6,8,14,29,10,39,57,34,91,132,53,185,229,85,314,286,215,501,272,336,608,102,262,364,1115,1008,2123
2020-07-20,2,3,5,0,2,2,6,8,14,30,12,42,59,34,93,134,55,189,236,87,323,293,223,516,283,343,626,103,264,367,1146,1031,2177
2020-07-21,2,3,5,0,2,2,9,8,17,30,12,42,61,34,95,136,55,191,249,91,340,299,227,526,292,355,647,105,274,379,1183,1061,2244
2020-07-22,2,3,5,0,2,2,9,8,17,30,12,42,61,34,95,139,55,194,255,93,348,307,232,539,300,363,663,108,282,390,1211,1084,2295
2020-07-23,2,3,5,0,2,2,9,8,17,30,13,43,62,34,96,142,57,199,261,94,355,312,239,551,306,373,679,108,286,394,1232,1109,2341
2020-07-24,2,3,5,0,2,2,9,8,17,30,13,43,65,34,99,145,58,203,266,96,362,318,242,560,314,389,703,110,290,400,1259,1135,2394
2020-07-25,2,4,6,0,2,2,9,8,17,30,13,43,65,34,99,147,61,208,270,96,366,321,246,567,320,396,716,115,301,416,1279,1161,2440
2020-07-26,2,4,6,0,2,2,10,8,18,31,13,44,67,34,101,147,62,209,273,96,369,326,252,578,330,402,732,117,307,424,1303,1180,2483
2020-07-27,2,4,6,0,2,2,10,8,18,31,14,45,68,35,103,152,65,217,274,98,372,329,259,588,342,407,749,119,312,431,1327,1204,2531
2020-07-28,2,4,6,0,2,2,10,9,19,31,14,45,69,36,105,154,67,221,279,101,380,338,267,605,352,418,770,120,317,437,1355,1235,2590
2020-07-29,2,4,6,0,2,2,10,9,19,32,15,47,70,37,107,156,68,224,284,101,385,343,270,613,357,424,781,124,318,442,1378,1248,2626
2020-07-30,2,4,6,0,2,2,10,9,19,32,15,47,74,40,114,156,68,224,286,102,388,348,274,622,361,433,794,126,323,449,1395,1270,2665
2020-07-31,2,4,6,0,2,2,10,10,20,32,15,47,76,42,118,158,70,228,290,104,394,354,279,633,364,441,805,127,334,461,1413,1301,2714
2020-08-01,2,4,6,0,2,2,10,10,20,32,15,47,78,43,121,160,71,231,293,106,399,358,283,641,369,447,816,130,339,469,1432,1320,2752
2020-08-02,2,4,6,0,2,2,10,10,20,33,15,48,79,44,123,162,71,233,295,108,403,367,289,656,373,459,832,131,344,475,1452,1346,2798
2020-08-03,2,4,6,0,2,2,11,10,21,33,15,48,80,45,125,165,72,237,303,111,414,377,297,674,378,473,851,132,356,488,1481,1385,2866
2020-08-04,2,5,7,0,2,2,11,10,21,33,15,48,81,46,127,168,75,243,311,114,425,383,300,683,387,485,872,135,367,502,1511,1419,2930
2020-08-05,2,6,8,0,2,2,11,10,21,33,15,48,82,47,129,171,79,250,319,116,435,388,305,693,397,500,897,138,374,512,1541,1454,2995
2020-08-06,2,6,8,0,2,2,11,10,21,35,15,50,84,47,131,174,80,254,323,118,441,392,311,703,405,508,913,141,381,522,1567,1478,3045
2020-08-07,2,6,8,0,2,2,11,10,21,36,15,51,85,49,134,175,80,255,324,121,445,395,316,711,413,513,926,145,383,528,1586,1495,3081
2020-08-08,2,6,8,0,2,2,11,10,21,37,15,52,85,50,135,176,82,258,329,124,453,400,319,719,419,520,939,146,387,533,1605,1515,3120
2020-08-09,2,6,8,0,2,2,11,10,21,37,15,52,85,51,136,178,83,261,338,129,467,405,322,727,426,525,951,149,387,536,1631,1530,3161
2020-08-10,2,6,8,0,2,2,11,10,21,38,15,53,86,52,138,179,87,266,342,132,474,411,325,736,431,535,966,149,392,541,1649,1556,3205
2020-08-11,2,6,8,0,2,2,11,10,21,39,15,54,87,52,139,180,87,267,347,136,483,416,329,745,435,543,978,151,395,546,1668,1575,3243
2020-08-12,3,6,9,0,2,2,11,10,21,39,15,54,88,52,140,181,89,270,348,139,487,422,333,755,437,548,985,153,398,551,1682,1592,3274
2020-08-13,3,6,9,0,2,2,11,10,21,39,15,54,88,52,140,181,91,272,354,142,496,430,335,765,443,555,998,154,399,553,1703,1607,3310
2020-08-14,3,6,9,0,2,2,11,10,21,39,15,54,90,52,142,181,91,272,358,144,502,435,336,771,449,560,1009,154,401,555,1720,1617,3337
2020-08-15,3,6,9,0,2,2,11,11,22,39,15,54,91,52,143,182,91,273,363,147,510,443,340,783,458,571,1029,154,409,563,1744,1644,3388
2020-08-16,3,6,9,0,2,2,11,11,22,39,15,54,93,52,145,182,92,274,367,147,514,447,343,790,465,577,1042,154,415,569,1761,1660,3421
2020-08-17,3,6,9,0,2,2,11,11,22,39,16,55,94,52,146,185,93,278,371,148,519,450,345,795,468,580,1048,154,419,573,1775,1672,3447
2020-08-18,3,6,9,0,2,2,13,11,24,39,16,55,94,52,146,187,94,281,375,149,524,458,348,806,471,597,1068,156,425,581,1796,1700,3496
2020-08-19,3,6,9,0,2,2,13,12,25,40,16,56,95,52,147,189,95,284,387,150,537,461,357,818,481,606,1087,161,427,588,1830,1723,3553
2020-08-20,3,6,9,0,2,2,13,12,25,41,16,57,96,52,148,189,95,284,398,151,549,466,363,829,490,610,1100,163,434,597,1859,1741,3600
2020-08-21,3,6,9,0,2,2,13,13,26,41,16,57,98,52,150,190,95,285,407,151,558,467,368,835,493,621,1114,165,439,604,1877,1763,3640
2020-08-22,3,6,9,0,2,2,13,13,26,41,16,57,100,52,152,190,95,285,413,153,566,471,371,842,500,625,1125,166,441,607,1897,1774,3671
2020-08-23,3,6,9,0,2,2,13,13,26,42,16,58,100,52,152,192,96,288,418,156,574,477,372,849,511,629,1140,169,447,616,1925,1789,3714
2020-08-24,3,6,9,0,2,2,13,13,26,43,16,59,101,52,153,194,96,290,423,162,585,481,377,858,516,631,1147,171,452,623,1945,1807,3752
2020-08-25,3,6,9,0,2,2,13,13,26,45,16,61,103,52,155,197,97,294,425,169,594,489,383,872,527,641,1168,173,456,629,1975,1835,3810
2020-08-26,3,6,9,0,2,2,13,13,26,45,17,62,103,55,158,199,97,296,430,171,601,495,388,883,533,652,1185,175,462,637,1996,1863,3859
2020-08-27,3,6,9,0,2,2,13,13,26,46,17,63,104,56,160,203,97,300,432,173,605,504,388,892,539,664,1203,179,466,645,2023,1882,3905
2020-08-28,3,6,9,0,2,2,13,13,26,46,17,63,105,56,161,207,97,304,435,175,610,513,391,904,544,671,1215,179,467,646,2045,1895,3940
2020-08-29,3,6,9,0,2,2,13,13,26,48,17,65,105,56,161,209,98,307,437,176,613,519,395,914,551,672,1223,179,470,649,2064,1905,3969
2020-08-30,3,6,9,0,2,2,13,13,26,49,17,66,105,57,162,212,98,310,444,176,620,526,400,926,555,675,1230,181,474,655,2088,1918,4006
2020-08-31,3,6,9,0,2,2,13,13,26,49,17,66,106,57,163,214,99,313,452,177,629,539,404,943,563,681,1244,181,475,656,2120,1931,4051
2020-09-01,3,6,9,0,2,2,13,13,26,49,17,66,107,57,164,214,99,313,460,178,638,547,408,955,568,690,1258,184,480,664,2145,1950,4095
2020-09-02,3,6,9,0,2,2,13,13,26,49,17,66,107,58,165,217,103,320,465,179,644,551,411,962,577,698,1275,184,483,667,2166,1970,4136
2020-09-03,3,6,9,0,2,2,13,13,26,49,17,66,108,60,168,219,104,323,470,179,649,558,418,976,586,704,1290,185,488,673,2191,1991,4182
2020-09-04,3,6,9,0,2,2,13,14,27,49,18,67,110,60,170,220,105,325,471,182,653,560,424,984,587,708,1295,186,490,676,2199,2009,4208
2020-09-05,3,6,9,0,2,2,13,14,27,49,18,67,110,61,171,221,106,327,477,186,663,569,427,996,590,718,1308,186,492,678,2218,2030,4248
2020-09-06,3,6,9,0,2,2,13,14,27,49,18,67,111,61,172,223,106,329,481,186,667,578,431,1009,592,723,1315,189,496,685,2239,2043,4282
2020-09-07,3,6,9,0,2,2,13,14,27,49,18,67,112,62,174,226,106,332,484,191,675,587,438,1025,602,730,1332,190,501,691,2266,2068,4334
2020-09-08,3,6,9,0,2,2,13,14,27,49,18,67,112,62,174,228,107,335,489,195,684,597,443,1040,610,740,1350,193,505,698,2294,2092,4386
2020-09-09,3,6,9,0,2,2,14,14,28,49,18,67,113,63,176,234,108,342,494,198,692,605,447,1052,613,745,1358,195,511,706,2320,2112,4432
2020-09-10,3,6,9,0,2,2,14,15,29,49,18,67,113,63,176,235,108,343,497,200,697,617,450,1067,616,752,1368,196,517,713,2340,2131,4471
2020-09-11,3,6,9,0,2,2,14,15,29,50,18,68,114,64,178,236,108,344,501,202,703,622,455,1077,619,760,1379,196,518,714,2355,2148,4503
2020-09-12,3,6,9,0,2,2,14,15,29,50,18,68,114,64,178,237,110,347,503,206,709,626,456,1082,623,764,1387,196,524,720,2366,2165,4531
2020-09-13,3,6,9,0,2,2,14,15,29,50,18,68,115,64,179,237,110,347,507,208,715,631,458,1089,623,768,1391,196,525,721,2376,2174,4550
2020-09-14,3,6,9,0,2,2,15,15,30,51,18,69,115,64,179,239,110,349,509,209,718,638,464,1102,628,772,1400,197,527,724,2395,2187,4582
2020-09-15,3,6,9,0,2,2,15,15,30,51,18,69,115,64,179,241,111,352,512,211,723,643,466,1109,634,775,1409,198,530,728,2412,2198,4610
2020-09-16,3,6,9,1,2,3,15,15,30,52,18,70,115,64,179,241,112,353,517,212,729,646,471,1117,637,781,1418,199,534,733,2426,2215,4641
2020-09-17,3,6,9,1,2,3,15,15,30,52,18,70,115,64,179,241,112,353,520,213,733,653,473,1126,640,785,1425,201,538,739,2441,2226,4667
2020-09-18,3,6,9,1,2,3,16,16,32,53,18,71,115,65,180,241,113,354,523,214,737,654,477,1131,645,789,1434,201,541,742,2452,2241,4693
2020-09-19,3,6,9,1,2,3,16,16,32,53,18,71,115,65,180,242,114,356,525,216,741,658,479,1137,647,794,1441,201,544,745,2461,2254,4715
2020-09-20,3,6,9,1,2,3,16,16,32,53,18,71,118,65,183,243,114,357,528,217,745,659,482,1141,649,796,1445,201,546,747,2471,2262,4733
2020-09-21,3,6,9,1,2,3,16,16,32,53,18,71,119,65,184,243,114,357,530,217,747,665,486,1151,650,801,1451,201,547,748,2481,2272,4753
2020-09-22,3,6,9,1,2,3,16,16,32,53,18,71,119,65,184,244,115,359,532,220,752,668,487,1155,655,806,1461,202,550,752,2493,2285,4778
2020-09-23,3,6,9,1,2,3,16,16,32,53,18,71,119,66,185,248,115,363,534,223,757,673,491,1164,657,810,1467,203,552,755,2507,2299,4806
2020-09-24,3,6,9,1,2,3,16,16,32,53,18,71,119,66,185,250,116,366,537,223,760,674,493,1167,662,815,1477,204,553,757,2519,2308,4827
2020-09-25,3,6,9,1,2,3,16,16,32,53,19,72,119,67,186,252,116,368,541,224,765,680,499,1179,664,819,1483,206,559,765,2535,2327,4862
2020-09-26,3,6,9,1,2,3,16,16,32,53,19,72,119,67,186,252,116,368,542,225,767,685,501,1186,668,823,1491,207,559,766,2546,2334,4880
2020-09-27,3,6,9,1,2,3,16,16,32,53,19,72,119,67,186,252,116,368,544,226,770,689,505,1194,671,827,1498,208,561,769,2556,2345,4901
2020-09-28,3,6,9,1,2,3,16,16,32,53,19,72,119,69,188,254,116,370,550,227,777,692,506,1198,679,829,1508,209,561,770,2576,2351,4927
2020-09-29,3,6,9,1,2,3,16,16,32,54,19,73,119,69,188,255,116,371,555,228,783,694,510,1204,683,834,1517,209,563,772,2589,2363,4952
2020-09-30,3,6,9,1,2,3,17,16,33,54,19,73,119,70,189,255,116,371,560,230,790,699,510,1209,686,838,1524,212,566,778,2606,2373,4979
2020-10-01,4,6,10,1,2,3,17,16,33,54,19,73,120,70,190,256,116,372,566,233,799,702,515,1217,688,841,1529,213,568,781,2621,2386,5007
2020-10-02,4,6,10,1,2,3,17,16,33,54,19,73,120,71,191,257,116,373,569,235,804,705,521,1226,690,844,1534,215,570,785,2632,2400,5032
2020-10-03,4,6,10,1,2,3,18,16,34,54,19,73,120,71,191,257,116,373,570,235,805,709,521,1230,690,846,1536,216,570,786,2639,2402,5041
2020-10-04,4,6,10,1,2,3,18,16,34,54,19,73,122,71,193,258,116,374,571,235,806,710,523,1233,694,847,1541,216,571,787,2648,2406,5054
2020-10-05,4,6,10,1,2,3,18,16,34,54,19,73,124,71,195,259,116,375,574,237,811,713,526,1239,697,852,1549,216,573,789,2660,2418,5078
2020-10-06,4,6,10,1,2,3,18,16,34,54,19,73,124,72,196,259,116,375,575,238,813,715,527,1242,704,854,1558,217,573,790,2671,2423,5094
2020-10-07,4,6,10,1,2,3,18,16,34,54,19,73,124,72,196,259,116,375,576,238,814,716,532,1248,708,858,1566,217,574,791,2677,2433,5110
2020-10-08,4,6,10,1,2,3,18,16,34,54,19,73,124,72,196,259,116,375,578,239,817,720,538,1258,713,864,1577,218,576,794,2689,2448,5137
2020-10-09,4,6,10,1,2,3,18,16,34,54,19,73,125,72,197,262,117,379,581,240,821,724,539,1263,717,868,1585,219,577,796,2705,2456,5161
2020-10-10,4,6,10,1,2,3,18,16,34,54,19,73,127,72,199,262,117,379,583,240,823,728,542,1270,720,870,1590,219,577,796,2716,2461,5177
2020-10-11,4,6,10,1,2,3,18,16,34,55,19,74,128,73,201,263,117,380,583,241,824,730,545,1275,722,871,1593,220,577,797,2724,2467,5191
2020-10-12,4,6,10,1,2,3,18,16,34,55,19,74,129,73,202,265,117,382,584,242,826,733,546,1279,724,873,1597,220,577,797,2733,2471,5204
2020-10-13,4,6,10,1,2,3,18,16,34,55,19,74,129,73,202,268,117,385,588,244,832,736,546,1282,726,880,1606,221,577,798,2746,2480,5226
2020-10-14,4,6,10,1,2,3,19,16,35,55,19,74,130,73,203,270,117,387,589,245,834,739,550,1289,729,883,1612,222,579,801,2758,2490,5248
2020-10-15,4,6,10,1,2,3,19,16,35,55,19,74,132,73,205,270,119,389,590,245,835,742,552,1294,732,886,1618,222,580,802,2767,2498,5265
2020-10-16,4,6,10,1,2,3,19,16,35,55,19,74,133,73,206,271,119,390,592,246,838,745,554,1299,736,889,1625,223,586,809,2779,2510,5289
2020-10-17,4,6,10,1,2,3,19,17,36,55,19,74,133,75,208,271,120,391,595,247,842,748,555,1303,740,889,1629,225,588,813,2791,2518,5309
2020-10-18,4,6,10,1,2,3,20,17,37,56,19,75,133,75,208,272,120,392,595,248,843,750,556,1306,740,890,1630,225,589,814,2796,2522,5318
2020-10-19,4,7,11,1,2,3,20,17,37,56,19,75,134,75,209,272,120,392,595,249,844,753,559,1312,740,893,1633,225,589,814,2800,2530,5330
2020-10-20,4,7,11,1,2,3,20,17,37,57,19,76,134,76,210,273,120,393,596,250,846,755,560,1315,746,895,1641,226,589,815,2812,2535,5347
2020-10-21,4,7,11,1,2,3,20,17,37,57,19,76,134,76,210,274,121,395,599,252,851,757,560,1317,747,895,1642,226,589,815,2819,2538,5357
2020-10-22,4,7,11,1,2,3,20,17,37,57,19,76,134,76,210,275,121,396,599,253,852,759,562,1321,748,896,1644,226,589,815,2823,2542,5365
2020-10-23,4,7,11,1,2,3,20,17,37,57,19,76,134,76,210,276,121,397,602,255,857,761,566,1327,751,899,1650,227,590,817,2833,2552,5385
2020-10-24,4,7,11,1,2,3,20,17,37,57,19,76,134,76,210,278,121,399,604,255,859,762,569,1331,751,901,1652,227,591,818,2838,2558,5396
2020-10-25,4,7,11,1,2,3,20,17,37,58,19,77,134,76,210,278,121,399,605,256,861,763,569,1332,752,903,1655,227,592,819,2842,2562,5404
2020-10-26,4,7,11,1,2,3,20,17,37,58,19,77,134,76,210,279,121,400,608,256,864,766,571,1337,756,907,1663,229,593,822,2855,2569,5424
2020-10-27,4,7,11,1,2,3,20,17,37,58,19,77,134,77,211,282,122,404,609,256,865,768,574,1342,759,910,1669,230,593,823,2865,2577,5442
2020-10-28,4,7,11,1,2,3,21,17,38,58,19,77,134,77,211,283,122,405,611,256,867,769,574,1343,762,911,1673,231,594,825,2874,2579,5453
2020-10-29,4,7,11,1,2,3,21,17,38,58,19,77,135,77,212,283,123,406,612,256,868,771,574,1345,764,912,1676,231,594,825,2880,2581,5461
2020-10-30,4,7,11,1,2,3,21,17,38,58,19,77,135,77,212,283,124,407,613,257,870,773,574,1347,766,913,1679,232,595,827,2886,2585,5471
2020-10-31,4,7,11,1,2,3,21,17,38,58,19,77,135,77,212,283,124,407,614,257,871,774,575,1349,766,913,1679,232,595,827,2888,2586,5474
2020-11-01,4,7,11,1,2,3,21,17,38,58,19,77,135,77,212,283,124,407,614,257,871,774,576,1350,768,914,1682,232,595,827,2890,2588,5478
2020-11-02,4,7,11,1,2,3,21,17,38,58,19,77,135,77,212,284,124,408,614,257,871,774,576,1350,768,914,1682,232,596,828,2891,2589,5480
2020-11-03,4,7,11,1,2,3,21,17,38,58,19,77,135,77,212,284,124,408,614,258,872,775,579,1354,768,916,1684,232,597,829,2892,2596,5488
2020-11-04,4,7,11,1,2,3,21,17,38,58,19,77,135,77,212,284,125,409,615,258,873,776,581,1357,769,917,1686,232,598,830,2895,2601,5496
2020-11-05,4,7,11,1,3,4,21,17,38,58,19,77,135,77,212,284,125,409,618,258,876,778,582,1360,769,918,1687,233,598,831,2901,2604,5505
2020-11-06,4,7,11,1,3,4,21,17,38,58,19,77,135,78,213,284,125,409,621,258,879,781,583,1364,772,920,1692,233,599,832,2910,2609,5519
2020-11-07,4,7,11,1,3,4,21,17,38,58,19,77,135,78,213,284,125,409,621,260,881,781,584,1365,774,920,1694,233,599,832,2912,2612,5524
2020-11-08,4,7,11,1,3,4,21,17,38,58,19,77,135,78,213,284,125,409,622,260,882,782,584,1366,776,921,1697,234,599,833,2917,2613,5530
2020-11-09,4,7,11,1,3,4,21,18,39,58,19,77,135,78,213,284,125,409,623,261,884,788,585,1373,777,927,1704,234,600,834,2925,2623,5548
2020-11-10,4,7,11,1,3,4,21,18,39,58,19,77,135,78,213,285,125,410,626,261,887,789,591,1380,777,931,1708,234,600,834,2930,2633,5563
2020-11-11,4,7,11,1,3,4,21,18,39,58,19,77,135,78,213,287,126,413,626,262,888,790,592,1382,777,933,1710,235,601,836,2934,2639,5573
2020-11-12,4,7,11,1,3,4,21,18,39,58,19,77,135,78,213,287,126,413,628,262,890,790,592,1382,777,933,1710,235,603,838,2936,2641,5577
2020-11-13,4,7,11,1,3,4,21,18,39,58,19,77,135,78,213,288,126,414,629,262,891,793,592,1385,778,936,1714,236,604,840,2943,2645,5588
2020-11-14,4,7,11,1,3,4,21,18,39,58,19,77,135,78,213,289,126,415,630,262,892,795,592,1387,780,938,1718,236,604,840,2949,2647,5596
2020-11-15,4,7,11,1,3,4,21,18,39,58,19,77,135,78,213,289,126,415,632,262,894,796,593,1389,781,940,1721,237,604,841,2954,2650,5604
2020-11-16,4,7,11,1,3,4,21,18,39,58,19,77,135,78,213,289,126,415,634,262,896,797,594,1391,784,941,1725,238,606,844,2961,2654,5615
2020-11-17,4,7,11,1,3,4,21,18,39,58,19,77,135,78,213,291,126,417,637,262,899,798,594,1392,786,946,1732,238,606,844,2969,2659,5628
2020-11-18,4,7,11,1,3,4,21,18,39,58,19,77,135,78,213,291,126,417,638,262,900,801,594,1395,788,946,1734,238,607,845,2975,2660,5635
2020-11-19,4,7,11,1,3,4,21,18,39,58,19,77,135,79,214,291,126,417,638,262,900,803,594,1397,789,947,1736,238,608,846,2978,2663,5641
2020-11-20,4,7,11,1,3,4,21,18,39,58,19,77,135,79,214,291,126,417,639,262,901,804,595,1399,792,948,1740,239,608,847,2984,2665,5649
2020-11-21,4,7,11,1,3,4,21,18,39,58,19,77,135,79,214,291,126,417,639,262,901,805,595,1400,793,949,1742,239,608,847,2986,2666,5652
2020-11-22,4,7,11,1,3,4,21,18,39,58,19,77,135,79,214,292,126,418,641,262,903,806,597,1403,794,950,1744,239,609,848,2991,2670,5661
2020-11-23,4,7,11,1,3,4,21,18,39,58,19,77,135,79,214,292,126,418,641,262,903,808,599,1407,794,952,1746,239,610,849,2993,2675,5668
2020-11-24,4,7,11,1,3,4,21,18,39,58,19,77,135,79,214,292,126,418,643,262,905,809,599,1408,796,952,1748,239,611,850,2998,2676,5674
2020-11-25,4,7,11,1,3,4,21,18,39,58,19,77,137,79,216,292,126,418,644,263,907,810,600,1410,797,953,1750,240,612,852,3004,2680,5684
2020-11-26,4,7,11,1,3,4,22,18,40,59,19,78,137,79,216,292,126,418,645,263,908,810,600,1410,798,954,1752,241,613,854,3009,2682,5691
2020-11-27,4,7,11,1,3,4,22,18,40,59,19,78,137,79,216,293,126,419,646,263,909,811,602,1413,798,954,1752,242,615,857,3013,2686,5699
2020-11-28,4,7,11,1,3,4,22,18,40,59,19,78,138,79,217,293,126,419,647,263,910,811,603,1414,799,955,1754,242,615,857,3016,2688,5704
2020-11-29,4,7,11,1,3,4,22,18,40,59,19,78,138,79,217,293,126,419,648,263,911,812,603,1415,799,956,1755,243,615,858,3019,2689,5708
2020-11-30,4,7,11,1,3,4,22,18,40,59,19,78,138,79,217,293,126,419,648,263,911,813,604,1417,799,957,1756,243,616,859,3020,2692,5712
2020-12-01,4,7,11,1,3,4,22,18,40,59,19,78,138,79,217,294,126,420,648,264,912,813,605,1418,800,957,1757,243,616,859,3022,2694,5716
2020-12-02,4,7,11,1,3,4,22,18,40,59,19,78,138,79,217,294,126,420,650,266,916,813,607,1420,801,959,1760,243,621,864,3025,2705,5730
2020-12-03,4,7,11,1,3,4,22,18,40,59,19,78,138,79,217,295,126,421,651,266,917,814,609,1423,803,959,1762,243,621,864,3030,2707,5737
2020-12-04,4,7,11,1,3,4,22,18,40,59,19,78,138,79,217,295,126,421,653,266,919,815,610,1425,807,960,1767,243,621,864,3037,2709,5746
2020-12-05,4,7,11,1,3,4,22,18,40,59,19,78,138,79,217,295,126,421,653,266,919,815,612,1427,812,961,1773,243,621,864,3042,2712,5754
2020-12-06,4,7,11,1,3,4,22,18,40,59,19,78,138,79,217,295,126,421,654,266,920,816,613,1429,813,962,1775,243,621,864,3045,2714,5759
2020-12-07,4,7,11,1,3,4,22,18,40,59,19,78,138,79,217,296,126,422,655,267,922,818,614,1432,815,963,1778,243,621,864,3051,2717,5768
2020-12-08,4,7,11,1,3,4,22,18,40,59,19,78,138,79,217,296,126,422,658,268,926,819,617,1436,816,964,1780,244,622,866,3057,2723,5780
2020-12-09,4,7,11,1,3,4,22,18,40,59,20,79,138,79,217,296,126,422,660,269,929,819,617,1436,816,964,1780,244,622,866,3059,2725,5784
2020-12-10,4,7,11,1,3,4,22,18,40,59,20,79,138,79,217,298,126,424,662,269,931,821,621,1442,817,966,1783,244,624,868,3066,2733,5799
2020-12-11,4,7,11,1,3,4,22,18,40,59,20,79,138,79,217,298,127,425,663,269,932,821,622,1443,818,969,1787,244,625,869,3068,2739,5807
2020-12-12,4,7,11,1,3,4,22,18,40,59,20,79,138,79,217,298,128,426,663,269,932,823,622,1445,819,969,1788,244,625,869,3071,2740,5811
2020-12-13,4,7,11,1,3,4,22,18,40,59,20,79,139,79,218,298,128,426,664,270,934,825,622,1447,822,969,1791,245,625,870,3079,2741,5820
2020-12-14,4,7,11,1,3,4,22,18,40,59,20,79,139,79,218,298,128,426,667,271,938,828,623,1451,823,970,1793,245,625,870,3086,2744,5830
2020-12-15,4,7,11,1,3,4,22,18,40,59,20,79,139,79,218,298,128,426,669,271,940,830,625,1455,824,970,1794,245,626,871,3091,2747,5838
2020-12-16,4,7,11,1,3,4,22,18,40,59,20,79,139,79,218,298,128,426,670,272,942,833,627,1460,827,973,1800,246,627,873,3099,2754,5853
2020-12-17,4,7,11,1,3,4,22,18,40,59,20,79,139,79,218,299,128,427,670,272,942,836,631,1467,827,973,1800,246,628,874,3103,2759,5862
2020-12-18,4,7,11,1,3,4,22,18,40,60,20,80,139,79,218,301,128,429,670,273,943,840,632,1472,827,976,1803,246,631,877,3110,2767,5877
2020-12-19,4,7,11,1,3,4,22,18,40,60,20,80,139,79,218,302,128,430,672,274,946,842,632,1474,827,978,1805,246,632,878,3115,2771,5886
2020-12-20,4,7,11,1,3,4,22,18,40,60,20,80,139,79,218,302,128,430,675,276,951,842,632,1474,828,978,1806,248,633,881,3121,2774,5895
2020-12-21,4,7,11,1,3,4,22,18,40,61,20,81,139,79,218,304,128,432,678,277,955,845,633,1478,831,982,1813,248,634,882,3133,2781,5914
2020-12-22,4,7,11,1,3,4,22,18,40,61,20,81,139,79,218,305,128,433,680,277,957,846,634,1480,831,983,1814,248,635,883,3137,2784,5921
2020-12-23,4,7,11,1,3,4,22,18,40,61,20,81,139,80,219,307,128,435,683,277,960,850,637,1487,834,986,1820,248,635,883,3149,2791,5940
2020-12-24,4,7,11,1,3,4,22,18,40,61,20,81,139,80,219,307,128,435,684,277,961,850,637,1487,835,987,1822,248,636,884,3151,2793,5944
2020-12-25,4,7,11,1,3,4,22,18,40,61,20,81,140,81,221,308,128,436,685,278,963,852,637,1489,835,987,1822,248,637,885,3156,2796,5952
2020-12-26,4,7,11,1,3,4,22,18,40,61,21,82,140,81,221,310,128,438,685,279,964,856,639,1495,837,990,1827,248,637,885,3164,2803,5967
2020-12-27,4,7,11,1,3,4,22,18,40,61,21,82,141,81,222,310,128,438,688,279,967,861,640,1501,838,991,1829,248,637,885,3174,2805,5979
2020-12-28,4,7,11,1,3,4,22,18,40,61,21,82,142,81,223,311,128,439,690,280,970,868,641,1509,844,996,1840,249,638,887,3192,2813,6005
2020-12-29,4,7,11,1,3,4,22,18,40,61,21,82,142,81,223,311,129,440,695,281,976,871,642,1513,849,997,1846,250,639,889,3206,2818,6024
2020-12-30,4,7,11,1,3,4,22,18,40,61,21,82,142,81,223,313,129,442,695,282,977,875,645,1520,850,998,1848,250,639,889,3213,2823,6036
2020-12-31,4,7,11,1,3,4,22,18,40,61,21,82,142,81,223,314,129,443,696,283,979,877,647,1524,852,1000,1852,250,639,889,3219,2828,6047
2021-01-01,4,7,11,1,3,4,22,18,40,61,21,82,142,81,223,314,129,443,698,284,982,880,649,1529,852,1000,1852,250,639,889,3224,2831,6055
2021-01-02,4,7,11,1,3,4,22,18,40,61,21,82,143,81,224,315,131,446,698,287,985,880,649,1529,854,1001,1855,253,639,892,3231,2837,6068
2021-01-03,4,7,11,1,3,4,22,18,40,61,21,82,143,81,224,318,133,451,698,287,985,882,650,1532,855,1003,1858,253,639,892,3237,2842,6079
2021-01-04,4,7,11,1,3,4,22,18,40,61,21,82,143,81,224,319,133,452,699,288,987,888,650,1538,861,1011,1872,255,640,895,3253,2852,6105
2021-01-05,4,7,11,1,3,4,22,18,40,61,22,83,144,81,225,319,133,452,702,289,991,889,650,1539,862,1013,1875,255,644,899,3259,2860,6119
2021-01-06,4,7,11,1,3,4,22,18,40,61,22,83,146,81,227,321,134,455,706,289,995,895,652,1547,862,1016,1878,255,644,899,3273,2866,6139
2021-01-07,4,7,11,1,3,4,23,18,41,61,22,83,146,82,228,321,135,456,709,291,1000,899,654,1553,866,1018,1884,260,645,905,3290,2875,6165
2021-01-08,4,7,11,1,3,4,23,18,41,61,22,83,146,82,228,324,136,460,715,293,1008,902,657,1559,868,1021,1889,260,646,906,3304,2885,6189
2021-01-09,4,7,11,1,3,4,23,18,41,61,22,83,147,82,229,325,137,462,715,293,1008,905,660,1565,868,1024,1892,260,647,907,3309,2893,6202
2021-01-10,4,7,11,1,3,4,23,18,41,61,22,83,147,82,229,327,137,464,718,295,1013,908,660,1568,870,1025,1895,260,647,907,3319,2896,6215
2021-01-11,4,7,11,1,3,4,23,18,41,61,23,84,148,82,230,330,137,467,723,295,1018,913,661,1574,871,1028,1899,260,650,910,3334,2904,6238
2021-01-12,4,7,11,1,3,4,23,18,41,61,23,84,148,82,230,331,137,468,728,297,1025,918,662,1580,873,1032,1905,260,652,912,3347,2913,6260
2021-01-13,4,7,11,1,3,4,23,18,41,61,23,84,148,82,230,336,140,476,730,298,1028,922,663,1585,876,1033,1909,261,654,915,3362,2921,6283
2021-01-14,4,7,11,1,3,4,23,18,41,61,23,84,148,82,230,338,140,478,734,300,1034,927,666,1593,881,1033,1914,263,654,917,3380,2926,6306
2021-01-15,4,7,11,1,3,4,23,18,41,62,23,85,148,83,231,338,140,478,736,301,1037,929,669,1598,885,1035,1920,263,654,917,3389,2933,6322
2021-01-16,4,7,11,1,3,4,23,18,41,62,23,85,148,83,231,338,140,478,736,302,1038,931,672,1603,886,1037,1923,263,654,917,3392,2939,6331
2021-01-17,4,7,11,1,3,4,23,18,41,62,24,86,148,83,231,338,140,478,738,302,1040,937,672,1609,889,1038,1927,263,654,917,3403,2941,6344
2021-01-18,4,7,11,1,3,4,23,18,41,62,24,86,148,83,231,338,140,478,742,305,1047,939,674,1613,891,1043,1934,264,655,919,3412,2952,6364
2021-01-19,4,7,11,1,3,4,23,18,41,62,24,86,148,83,231,341,140,481,743,305,1048,942,676,1618,896,1047,1943,264,657,921,3424,2960,6384
2021-01-20,4,7,11,1,3,4,23,18,41,62,25,87,148,83,231,343,140,483,747,306,1053,946,676,1622,900,1051,1951,264,661,925,3438,2970,6408
2021-01-21,4,7,11,1,3,4,23,18,41,62,25,87,149,83,232,346,141,487,751,308,1059,950,678,1628,903,1057,1960,266,662,928,3455,2982,6437
2021-01-22,4,7,11,1,3,4,23,18,41,62,25,87,149,83,232,346,141,487,755,310,1065,951,679,1630,904,1060,1964,267,663,930,3462,2989,6451
2021-01-23,4,7,11,1,3,4,24,18,42,62,25,87,149,83,232,346,141,487,755,310,1065,957,684,1641,905,1063,1968,267,663,930,3470,2997,6467
2021-01-24,4,7,11,1,3,4,24,18,42,62,25,87,149,83,232,346,141,487,756,311,1067,959,686,1645,906,1063,1969,267,663,930,3474,3000,6474
2021-01-25,4,7,11,1,3,4,24,18,42,62,26,88,149,83,232,347,141,488,757,312,1069,963,689,1652,908,1066,1974,268,664,932,3483,3009,6492
2021-01-26,4,7,11,1,3,4,24,18,42,62,26,88,150,83,233,348,142,490,760,313,1073,965,692,1657,912,1069,1981,268,666,934,3494,3019,6513
2021-01-27,4,7,11,1,3,4,24,18,42,62,26,88,151,83,234,348,142,490,761,314,1075,968,693,1661,915,1074,1989,269,666,935,3503,3026,6529
2021-01-28,4,7,11,1,3,4,24,18,42,62,26,88,151,83,234,348,142,490,761,315,1076,970,696,1666,917,1075,1992,269,667,936,3507,3032,6539
2021-01-29,4,7,11,1,3,4,24,18,42,62,26,88,151,84,235,349,142,491,763,315,1078,974,696,1670,919,1079,1998,271,668,939,3518,3038,6556
2021-01-30,4,7,11,1,3,4,24,18,42,62,26,88,151,84,235,351,142,493,765,317,1082,974,697,1671,919,1081,2000,272,668,940,3523,3043,6566
2021-01-31,4,7,11,1,3,4,24,18,42,62,26,88,151,84,235,352,142,494,765,317,1082,980,699,1679,919,1082,2001,272,669,941,3530,3047,6577
2021-02-01,4,7,11,1,3,4,24,18,42,62,26,88,151,84,235,353,143,496,768,319,1087,984,703,1687,922,1084,2006,272,670,942,3541,3057,6598
2021-02-02,4,7,11,1,3,4,24,18,42,62,26,88,151,84,235,354,145,499,769,320,1089,987,706,1693,924,1089,2013,272,672,944,3548,3070,6618
2021-02-03,4,7,11,1,3,4,24,18,42,62,26,88,153,84,237,354,146,500,771,322,1093,990,707,1697,928,1090,2018,273,672,945,3560,3075,6635
2021-02-04,4,7,11,1,3,4,24,18,42,62,26,88,154,85,239,355,146,501,777,325,1102,996,710,1706,932,1093,2025,273,673,946,3578,3086,6664
2021-02-05,4,7,11,1,3,4,24,18,42,62,26,88,154,85,239,356,146,502,779,326,1105,999,712,1711,934,1094,2028,273,675,948,3586,3092,6678
2021-02-06,4,7,11,1,3,4,24,18,42,62,26,88,154,87,241,356,146,502,781,328,1109,1003,713,1716,936,1094,2030,273,676,949,3594,3098,6692
2021-02-07,4,7,11,1,3,4,24,18,42,62,26,88,154,87,241,356,147,503,782,330,1112,1008,714,1722,940,1096,2036,273,677,950,3604,3105,6709
2021-02-08,4,7,11,1,3,4,24,18,42,62,26,88,154,87,241,359,147,506,786,330,1116,1014,723,1737,942,1100,2042,273,678,951,3619,3119,6738
2021-02-09,4,7,11,1,3,4,24,18,42,62,26,88,155,87,242,359,147,506,787,332,1119,1015,726,1741,945,1101,2046,273,678,951,3625,3125,6750
2021-02-10,4,7,11,1,3,4,24,18,42,63,26,89,155,87,242,360,147,507,788,333,1121,1017,729,1746,945,1105,2050,274,678,952,3631,3133,6764
2021-02-11,4,7,11,1,3,4,24,18,42,63,26,89,155,87,242,360,147,507,790,334,1124,1021,730,1751,946,1105,2051,275,679,954,3639,3136,6775
2021-02-12,4,7,11,1,3,4,24,18,42,63,26,89,156,87,243,361,148,509,791,336,1127,1025,735,1760,948,1108,2056,277,680,957,3650,3148,6798
2021-02-13,4,7,11,1,3,4,24,18,42,63,26,89,156,88,244,361,148,509,792,336,1128,1030,738,1768,948,1111,2059,278,681,959,3657,3156,6813
2021-02-14,4,7,11,1,3,4,24,18,42,63,26,89,156,88,244,361,148,509,793,337,1130,1033,741,1774,948,1112,2060,278,681,959,3661,3161,6822
2021-02-15,4,7,11,1,3,4,24,18,42,64,26,90,157,88,245,361,148,509,795,337,1132,1034,742,1776,950,1113,2063,278,682,960,3668,3164,6832
2021-02-16,4,7,11,1,3,4,24,18,42,64,26,90,157,88,245,361,148,509,795,337,1132,1037,743,1780,952,1116,2068,278,686,964,3673,3172,6845
2021-02-17,4,7,11,1,3,4,24,18,42,64,26,90,157,88,245,361,148,509,796,337,1133,1039,743,1782,955,1118,2073,278,686,964,3679,3174,6853
2021-02-18,4,7,11,1,3,4,24,18,42,65,26,91,157,88,245,362,149,511,800,338,1138,1041,744,1785,955,1120,2075,278,686,964,3687,3179,6866
2021-02-19,4,7,11,1,3,4,24,18,42,65,26,91,157,88,245,365,151,516,801,340,1141,1043,744,1787,955,1120,2075,278,686,964,3693,3183,6876
2021-02-20,4,7,11,1,3,4,24,18,42,65,26,91,158,88,246,365,151,516,802,340,1142,1044,746,1790,956,1121,2077,279,687,966,3698,3187,6885
2021-02-21,4,7,11,1,3,4,24,18,42,65,27,92,158,88,246,365,151,516,804,340,1144,1045,748,1793,958,1122,2080,279,688,967,3703,3192,6895
2021-02-22,4,7,11,1,3,4,24,18,42,65,27,92,158,88,246,366,151,517,806,341,1147,1047,750,1797,960,1124,2084,281,688,969,3712,3197,6909
2021-02-23,4,7,11,1,3,4,24,18,42,65,27,92,158,88,246,367,152,519,807,341,1148,1048,752,1800,963,1126,2089,282,688,970,3719,3202,6921
2021-02-24,4,7,11,1,3,4,24,18,42,65,28,93,158,88,246,368,152,520,808,342,1150,1050,753,1803,965,1126,2091,282,691,973,3725,3208,6933
2021-02-25,4,7,11,1,3,4,24,18,42,65,28,93,158,88,246,369,152,521,810,342,1152,1053,755,1808,966,1127,2093,283,691,974,3733,3211,6944
2021-02-26,4,7,11,1,3,4,24,18,42,65,28,93,158,88,246,370,152,522,810,343,1153,1057,756,1813,967,1132,2099,285,692,977,3741,3219,6960
2021-02-27,4,7,11,1,3,4,24,18,42,65,28,93,158,88,246,372,152,524,810,343,1153,1058,758,1816,973,1135,2108,285,693,978,3750,3225,6975
2021-02-28,4,7,11,1,3,4,24,18,42,65,28,93,158,88,246,373,152,525,811,343,1154,1058,758,1816,973,1136,2109,285,693,978,3752,3226,6978
2021-03-01,4,7,11,1,3,4,24,18,42,65,28,93,158,88,246,374,152,526,812,343,1155,1060,762,1822,974,1140,2114,285,693,978,3757,3234,6991
2021-03-02,4,7,11,1,3,4,24,18,42,65,28,93,159,88,247,374,152,526,814,344,1158,1063,763,1826,976,1141,2117,285,694,979,3765,3238,7003
2021-03-03,4,7,11,1,3,4,24,18,42,65,28,93,161,88,249,374,152,526,815,345,1160,1064,764,1828,979,1141,2120,285,694,979,3772,3240,7012
2021-03-04,4,7,11,2,3,5,24,18,42,65,28,93,161,88,249,375,152,527,816,347,1163,1067,765,1832,981,1141,2122,285,694,979,3780,3243,7023
2021-03-05,4,7,11,2,3,5,24,18,42,65,28,93,162,88,250,376,152,528,818,347,1165,1070,766,1836,982,1143,2125,285,694,979,3788,3246,7034
2021-03-06,4,7,11,2,3,5,24,19,43,65,28,93,162,88,250,376,152,528,819,347,1166,1071,766,1837,983,1143,2126,285,695,980,3791,3248,7039
2021-03-07,4,7,11,2,3,5,24,19,43,65,28,93,162,88,250,376,152,528,820,349,1169,1073,766,1839,984,1143,2127,285,696,981,3795,3251,7046
2021-03-08,4,7,11,2,3,5,24,19,43,65,28,93,162,88,250,376,154,530,822,349,1171,1075,766,1841,987,1144,2131,286,696,982,3803,3254,7057
2021-03-09,4,7,11,2,3,5,24,19,43,65,28,93,162,88,250,379,154,533,824,351,1175,1078,766,1844,991,1146,2137,286,697,983,3815,3259,7074
2021-03-10,4,7,11,2,3,5,24,19,43,65,28,93,163,88,251,379,154,533,826,355,1181,1082,771,1853,991,1148,2139,286,698,984,3822,3271,7093
2021-03-11,4,7,11,2,3,5,24,19,43,65,28,93,163,88,251,381,154,535,830,355,1185,1085,772,1857,995,1149,2144,286,699,985,3835,3274,7109
2021-03-12,4,7,11,2,3,5,24,19,43,65,28,93,163,89,252,382,155,537,830,355,1185,1093,775,1868,996,1153,2149,286,704,990,3845,3288,7133
2021-03-13,4,7,11,2,3,5,24,19,43,65,28,93,163,89,252,382,155,537,831,355,1186,1096,778,1874,998,1153,2151,286,704,990,3851,3291,7142
2021-03-14,4,7,11,2,3,5,24,19,43,65,28,93,164,89,253,382,155,537,832,355,1187,1099,779,1878,1001,1154,2155,286,704,990,3859,3293,7152
2021-03-15,4,7,11,2,3,5,24,19,43,65,28,93,164,89,253,383,155,538,833,358,1191,1101,780,1881,1001,1157,2158,286,706,992,3863,3302,7165
2021-03-16,4,7,11,2,3,5,24,19,43,65,28,93,164,89,253,385,155,540,834,359,1193,1103,780,1883,1002,1162,2164,287,706,993,3870,3308,7178
2021-03-17,4,7,11,2,3,5,24,19,43,65,28,93,164,89,253,385,155,540,838,359,1197,1106,783,1889,1003,1162,2165,287,708,995,3878,3313,7191
2021-03-18,4,7,11,2,3,5,24,19,43,65,28,93,165,89,254,386,155,541,838,360,1198,1109,789,1898,1004,1164,2168,287,710,997,3884,3324,7208
2021-03-19,4,7,11,2,3,5,24,19,43,65,28,93,166,89,255,387,156,543,843,364,1207,1109,793,1902,1005,1166,2171,287,710,997,3892,3335,7227
2021-03-20,4,7,11,2,3,5,25,19,44,65,28,93,167,89,256,387,157,544,846,366,1212,1111,793,1904,1006,1167,2173,287,710,997,3900,3339,7239
2021-03-21,4,7,11,2,3,5,25,19,44,65,28,93,167,89,256,390,157,547,847,366,1213,1114,795,1909,1008,1170,2178,287,710,997,3909,3344,7253
2021-03-22,4,7,11,2,3,5,25,19,44,65,28,93,167,89,256,390,157,547,850,368,1218,1115,795,1910,1012,1172,2184,288,711,999,3918,3349,7267
2021-03-23,4,7,11,2,3,5,25,19,44,65,28,93,168,89,257,392,158,550,852,369,1221,1123,799,1922,1013,1173,2186,288,712,1000,3932,3357,7289
2021-03-24,4,7,11,2,3,5,25,19,44,65,28,93,169,90,259,392,158,550,857,370,1227,1127,799,1926,1015,1173,2188,289,713,1002,3945,3360,7305
2021-03-25,4,7,11,2,3,5,25,19,44,66,28,94,169,91,260,392,160,552,859,372,1231,1132,803,1935,1018,1178,2196,289,713,1002,3956,3374,7330
2021-03-26,4,7,11,2,3,5,25,19,44,66,28,94,170,91,261,393,161,554,862,375,1237,1140,807,1947,1023,1179,2202,289,714,1003,3974,3384,7358
2021-03-27,4,7,11,2,3,5,25,19,44,66,28,94,170,92,262,395,161,556,866,376,1242,1148,810,1958,1030,1184,2214,290,715,1005,3996,3395,7391
2021-03-28,4,7,11,2,3,5,25,19,44,66,29,95,172,92,264,397,162,559,867,379,1246,1156,813,1969,1031,1184,2215,290,715,1005,4010,3403,7413
2021-03-29,4,7,11,2,3,5,25,19,44,66,29,95,172,92,264,401,163,564,873,381,1254,1170,817,1987,1036,1187,2223,291,718,1009,4040,3416,7456
2021-03-30,4,7,11,2,3,5,25,19,44,67,30,97,174,92,266,403,164,567,879,381,1260,1177,819,1996,1037,1192,2229,294,719,1013,4062,3426,7488
2021-03-31,4,7,11,2,3,5,25,19,44,67,30,97,174,93,267,407,164,571,887,383,1270,1183,826,2009,1038,1195,2233,294,719,1013,4081,3439,7520
2021-04-01,4,7,11,2,3,5,25,19,44,67,31,98,175,93,268,412,165,577,894,385,1279,1189,827,2016,1039,1197,2236,296,719,1015,4103,3446,7549
2021-04-02,4,7,11,2,3,5,25,19,44,68,31,99,177,93,270,415,166,581,900,388,1288,1192,830,2022,1040,1199,2239,297,719,1016,4120,3455,7575
2021-04-03,4,7,11,2,3,5,25,19,44,68,31,99,179,93,272,419,166,585,903,392,1295,1203,833,2036,1042,1199,2241,299,720,1019,4144,3463,7607
2021-04-04,5,7,12,2,3,5,26,19,45,68,32,100,179,94,273,421,166,587,911,394,1305,1211,835,2046,1045,1200,2245,300,721,1021,4168,3471,7639
2021-04-05,5,7,12,2,3,5,26,19,45,68,32,100,180,95,275,422,167,589,921,401,1322,1216,839,2055,1050,1206,2256,300,722,1022,4190,3491,7681
2021-04-06,5,7,12,2,3,5,26,19,45,68,32,100,181,96,277,427,170,597,929,404,1333,1224,845,2069,1057,1208,2265,302,725,1027,4221,3509,7730
2021-04-07,5,7,12,2,3,5,27,19,46,70,32,102,183,97,280,430,174,604,934,409,1343,1233,849,2082,1059,1209,2268,304,729,1033,4247,3528,7775
2021-04-08,5,7,12,2,3,5,27,19,46,70,32,102,184,97,281,435,175,610,940,412,1352,1244,853,2097,1063,1210,2273,305,731,1036,4275,3539,7814
2021-04-09,5,7,12,2,3,5,27,19,46,70,32,102,187,97,284,439,175,614,953,419,1372,1250,856,2106,1068,1212,2280,306,734,1040,4307,3554,7861
2021-04-10,5,7,12,2,3,5,27,19,46,70,33,103,187,97,284,446,175,621,960,423,1383,1257,861,2118,1069,1214,2283,307,736,1043,4330,3568,7898
2021-04-11,5,7,12,2,3,5,27,20,47,71,33,104,187,97,284,451,177,628,972,427,1399,1267,872,2139,1071,1219,2290,309,740,1049,4362,3595,7957
2021-04-12,5,7,12,2,3,5,27,21,48,71,34,105,188,97,285,455,181,636,976,431,1407,1276,883,2159,1072,1222,2294,309,741,1050,4381,3620,8001
2021-04-13,5,7,12,2,3,5,27,21,48,71,34,105,189,100,289,464,182,646,986,433,1419,1290,890,2180,1077,1228,2305,309,744,1053,4420,3642,8062
2021-04-14,6,7,13,2,3,5,27,21,48,72,35,107,192,100,292,473,184,657,1000,441,1441,1308,895,2203,1078,1229,2307,311,747,1058,4469,3662,8131
2021-04-15,6,7,13,2,3,5,27,21,48,73,35,108,192,100,292,476,188,664,1007,445,1452,1313,903,2216,1081,1235,2316,311,749,1060,4488,3686,8174
2021-04-16,6,7,13,2,3,5,27,21,48,73,35,108,194,101,295,477,189,666,1015,451,1466,1326,905,2231,1087,1239,2326,312,751,1063,4519,3702,8221
2021-04-17,6,7,13,2,3,5,27,21,48,74,35,109,196,102,298,484,191,675,1026,458,1484,1338,917,2255,1089,1244,2333,313,751,1064,4555,3729,8284
2021-04-18,6,7,13,2,3,5,27,21,48,74,35,109,197,103,300,489,192,681,1033,464,1497,1346,922,2268,1095,1250,2345,313,754,1067,4582,3751,8333
2021-04-19,6,7,13,2,3,5,27,21,48,74,36,110,198,103,301,494,194,688,1040,473,1513,1359,924,2283,1097,1259,2356,313,756,1069,4610,3776,8386
2021-04-20,6,7,13,2,3,5,27,21,48,74,36,110,201,107,308,498,195,693,1048,477,1525,1369,927,2296,1104,1267,2371,315,758,1073,4644,3798,8442
2021-04-21,6,7,13,2,3,5,27,21,48,74,36,110,201,110,311,509,201,710,1057,485,1542,1386,930,2316,1111,1274,2385,316,761,1077,4689,3828,8517
2021-04-22,6,7,13,2,3,5,28,21,49,74,36,110,203,111,314,511,202,713,1065,491,1556,1397,938,2335,1119,1278,2397,318,764,1082,4723,3851,8574
2021-04-23,6,7,13,2,3,5,28,21,49,75,36,111,205,111,316,516,204,720,1073,498,1571,1400,941,2341,1126,1278,2404,318,770,1088,4749,3869,8618
2021-04-24,6,7,13,2,3,5,28,21,49,77,37,114,206,111,317,525,204,729,1081,502,1583,1408,943,2351,1127,1284,2411,318,770,1088,4778,3882,8660
2021-04-25,6,7,13,2,3,5,28,21,49,78,37,115,206,112,318,529,205,734,1090,507,1597,1413,948,2361,1132,1289,2421,319,770,1089,4803,3899,8702
2021-04-26,6,7,13,2,3,5,29,21,50,79,37,116,206,112,318,534,206,740,1098,514,1612,1418,959,2377,1135,1295,2430,320,772,1092,4827,3926,8753
2021-04-27,6,7,13,2,3,5,29,21,50,80,38,118,208,113,321,540,209,749,1109,518,1627,1428,965,2393,1142,1300,2442,322,773,1095,4866,3947,8813
2021-04-28,6,7,13,2,3,5,30,22,52,81,39,120,210,116,326,547,211,758,1122,525,1647,1433,971,2404,1142,1302,2444,323,774,1097,4896,3970,8866
2021-04-29,7,7,14,2,3,5,30,22,52,81,39,120,213,117,330,554,214,768,1132,535,1667,1436,982,2418,1145,1305,2450,323,774,1097,4923,3998,8921
2021-04-30,7,7,14,2,3,5,30,22,52,81,39,120,215,119,334,555,215,770,1138,544,1682,1445,990,2435,1149,1305,2454,325,776,1101,4947,4020,8967
2021-05-01,7,7,14,2,3,5,31,23,54,83,39,122,215,119,334,556,218,774,1146,550,1696,1452,993,2445,1150,1307,2457,325,778,1103,4967,4037,9004
2021-05-02,7,7,14,2,3,5,31,23,54,84,39,123,216,119,335,559,220,779,1152,551,1703,1458,997,2455,1152,1309,2461,326,780,1106,4987,4048,9035
2021-05-03,7,7,14,2,3,5,31,23,54,85,41,126,216,119,335,565,221,786,1159,554,1713,1464,1005,2469,1156,1317,2473,330,781,1111,5015,4071,9086
2021-05-04,8,7,15,2,3,5,32,23,55,85,41,126,216,121,337,571,223,794,1170,560,1730,1472,1012,2484,1159,1323,2482,331,783,1114,5046,4096,9142
2021-05-05,8,7,15,2,3,5,32,23,55,85,42,127,219,122,341,579,227,806,1181,565,1746,1474,1017,2491,1164,1327,2491,334,785,1119,5078,4118,9196
2021-05-06,8,7,15,2,3,5,32,23,55,86,42,128,225,124,349,587,227,814,1190,569,1759,1477,1019,2496,1168,1330,2498,334,787,1121,5109,4131,9240
2021-05-07,8,7,15,2,3,5,32,23,55,86,42,128,226,125,351,591,228,819,1196,573,1769,1479,1023,2502,1175,1334,2509,334,789,1123,5129,4147,9276
2021-05-08,8,7,15,3,3,6,32,23,55,87,42,129,227,125,352,598,229,827,1202,575,1777,1483,1026,2509,1177,1337,2514,336,793,1129,5153,4160,9313
2021-05-09,8,7,15,3,3,6,32,23,55,87,42,129,228,126,354,599,229,828,1210,581,1791,1488,1028,2516,1178,1340,2518,336,796,1132,5169,4175,9344
2021-05-10,8,7,15,3,3,6,32,23,55,87,42,129,230,126,356,602,231,833,1221,586,1807,1499,1033,2532,1182,1352,2534,338,797,1135,5202,4200,9402
2021-05-11,8,7,15,3,3,6,32,23,55,89,42,131,233,126,359,604,234,838,1227,589,1816,1505,1041,2546,1187,1355,2542,341,799,1140,5229,4219,9448
2021-05-12,8,7,15,3,3,6,32,23,55,90,42,132,235,127,362,611,235,846,1236,591,1827,1508,1044,2552,1190,1356,2546,344,800,1144,5257,4228,9485
2021-05-13,8,7,15,3,3,6,33,25,58,91,42,133,236,127,363,617,238,855,1242,594,1836,1513,1047,2560,1191,1358,2549,345,801,1146,5279,4242,9521
2021-05-14,8,7,15,3,3,6,33,25,58,92,43,135,239,129,368,620,242,862,1244,599,1843,1519,1051,2570,1193,1363,2556,345,804,1149,5296,4266,9562
2021-05-15,8,7,15,3,3,6,33,25,58,92,43,135,241,130,371,625,244,869,1247,603,1850,1525,1057,2582,1197,1363,2560,345,805,1150,5316,4280,9596
2021-05-16,8,7,15,3,3,6,33,25,58,95,45,140,243,130,373,631,245,876,1253,607,1860,1532,1060,2592,1197,1367,2564,346,809,1155,5341,4298,9639
2021-05-17,8,7,15,3,3,6,34,25,59,96,46,142,245,133,378,635,253,888,1264,611,1875,1542,1068,2610,1205,1373,2578,348,809,1157,5380,4328,9708
2021-05-18,8,7,15,3,3,6,34,25,59,96,46,142,248,134,382,640,254,894,1271,614,1885,1549,1073,2622,1206,1378,2584,350,811,1161,5405,4345,9750
2021-05-19,8,7,15,4,3,7,34,25,59,96,46,142,251,135,386,646,256,902,1284,617,1901,1555,1078,2633,1211,1381,2592,352,813,1165,5441,4361,9802
2021-05-20,8,7,15,4,3,7,34,25,59,97,47,144,255,138,393,655,258,913,1293,620,1913,1565,1087,2652,1215,1385,2600,352,815,1167,5478,4385,9863
2021-05-21,9,7,16,4,3,7,34,25,59,98,47,145,257,138,395,663,259,922,1301,625,1926,1569,1092,2661,1217,1388,2605,354,816,1170,5506,4400,9906
2021-05-22,9,7,16,4,3,7,34,25,59,98,47,145,259,139,398,666,263,929,1311,631,1942,1575,1096,2671,1220,1394,2614,356,821,1177,5532,4426,9958
2021-05-23,9,7,16,4,4,8,34,25,59,99,47,146,259,140,399,672,264,936,1316,632,1948,1581,1101,2682,1228,1397,2625,357,823,1180,5559,4440,9999
2021-05-24,9,7,16,4,4,8,35,26,61,102,47,149,263,142,405,676,265,941,1324,633,1957,1591,1105,2696,1234,1400,2634,358,825,1183,5596,4454,10050
2021-05-25,9,7,16,4,4,8,35,26,61,105,47,152,268,143,411,679,266,945,1327,636,1963,1594,1106,2700,1239,1402,2641,358,826,1184,5618,4463,10081
2021-05-26,9,7,16,4,4,8,35,27,62,105,47,152,269,143,412,690,267,957,1335,642,1977,1603,1114,2717,1246,1412,2658,358,827,1185,5654,4490,10144
2021-05-27,9,7,16,4,4,8,36,27,63,107,48,155,270,143,413,697,269,966,1343,642,1985,1611,1119,2730,1250,1418,2668,359,830,1189,5686,4507,10193
2021-05-28,9,7,16,4,4,8,36,27,63,108,48,156,271,144,415,702,272,974,1348,644,1992,1614,1122,2736,1250,1423,2673,361,830,1191,5703,4521,10224
2021-05-29,9,7,16,4,4,8,36,27,63,108,48,156,273,144,417,708,273,981,1350,650,2000,1618,1124,2742,1251,1426,2677,361,830,1191,5718,4533,10251
2021-05-30,9,7,16,4,4,8,36,28,64,108,48,156,276,145,421,711,273,984,1353,656,2009,1622,1127,2749,1255,1428,2683,361,831,1192,5735,4547,10282
2021-05-31,9,7,16,4,4,8,36,28,64,109,48,157,277,147,424,719,278,997,1357,658,2015,1624,1129,2753,1262,1431,2693,362,832,1194,5759,4562,10321
2021-06-01,9,7,16,4,4,8,36,28,64,109,48,157,279,148,427,724,280,1004,1363,659,2022,1628,1132,2760,1265,1436,2701,365,834,1199,5782,4576,10358
2021-06-02,9,7,16,4,4,8,36,28,64,109,48,157,279,149,428,727,284,1011,1367,660,2027,1634,1136,2770,1270,1442,2712,368,836,1204,5803,4594,10397
2021-06-03,9,7,16,4,4,8,36,28,64,109,48,157,281,150,431,731,287,1018,1369,664,2033,1642,1141,2783,1274,1446,2720,371,836,1207,5826,4611,10437
2021-06-04,9,7,16,4,4,8,36,28,64,110,48,158,285,150,435,737,288,1025,1371,666,2037,1645,1143,2788,1278,1453,2731,371,837,1208,5846,4624,10470
2021-06-05,9,7,16,4,4,8,36,28,64,110,48,158,287,150,437,739,289,1028,1376,670,2046,1649,1145,2794,1284,1459,2743,372,838,1210,5866,4638,10504
2021-06-06,9,8,17,4,4,8,36,28,64,110,49,159,288,150,438,743,290,1033,1378,670,2048,1651,1146,2797,1285,1461,2746,374,840,1214,5878,4646,10524
2021-06-07,9,8,17,4,4,8,36,28,64,111,49,160,290,150,440,750,292,1042,1384,671,2055,1653,1149,2802,1293,1465,2758,376,843,1219,5906,4659,10565
2021-06-08,9,9,18,4,4,8,36,28,64,111,49,160,292,150,442,753,295,1048,1388,673,2061,1663,1151,2814,1298,1469,2767,377,843,1220,5931,4671,10602
2021-06-09,9,9,18,4,4,8,36,28,64,112,49,161,296,151,447,755,297,1052,1391,675,2066,1667,1152,2819,1305,1470,2775,377,844,1221,5952,4679,10631
2021-06-10,9,9,18,4,4,8,38,28,66,112,49,161,298,153,451,757,298,1055,1392,679,2071,1673,1155,2828,1309,1473,2782,379,846,1225,5971,4694,10665
2021-06-11,9,9,18,4,4,8,38,28,66,113,50,163,300,153,453,759,299,1058,1394,681,2075,1677,1158,2835,1312,1476,2788,381,848,1229,5987,4706,10693
2021-06-12,9,9,18,5,4,9,38,28,66,113,50,163,301,155,456,761,300,1061,1394,682,2076,1679,1160,2839,1312,1479,2791,381,850,1231,5993,4717,10710
2021-06-13,9,9,18,5,4,9,38,28,66,113,50,163,306,155,461,764,300,1064,1397,684,2081,1679,1162,2841,1317,1481,2798,381,852,1233,6009,4725,10734
2021-06-14,9,9,18,5,4,9,38,28,66,114,51,165,308,155,463,766,301,1067,1400,685,2085,1683,1164,2847,1320,1485,2805,382,854,1236,6025,4736,10761
2021-06-15,9,9,18,5,4,9,38,29,67,114,51,165,309,155,464,768,301,1069,1403,686,2089,1686,1168,2854,1322,1492,2814,382,857,1239,6036,4752,10788
2021-06-16,9,9,18,5,4,9,38,29,67,114,52,166,311,155,466,769,301,1070,1405,687,2092,1689,1172,2861,1323,1494,2817,383,859,1242,6046,4762,10808
2021-06-17,9,9,18,5,4,9,39,29,68,115,52,167,311,155,466,774,304,1078,1407,689,2096,1695,1174,2869,1324,1495,2819,383,859,1242,6062,4770,10832
2021-06-18,9,9,18,5,4,9,39,29,68,115,52,167,311,155,466,774,305,1079,1413,689,2102,1698,1175,2873,1324,1498,2822,384,860,1244,6072,4776,10848
2021-06-19,9,9,18,5,4,9,39,29,68,115,52,167,313,155,468,776,308,1084,1416,690,2106,1699,1181,2880,1325,1501,2826,385,861,1246,6082,4790,10872
2021-06-20,9,9,18,5,4,9,39,29,68,115,52,167,313,155,468,779,309,1088,1418,691,2109,1701,1182,2883,1326,1502,2828,385,863,1248,6090,4796,10886
2021-06-21,9,9,18,5,4,9,39,29,68,115,53,168,314,155,469,780,311,1091,1418,693,2111,1702,1183,2885,1327,1502,2829,385,865,1250,6094,4804,10898
2021-06-22,9,9,18,5,4,9,39,30,69,115,54,169,317,155,472,784,312,1096,1419,694,2113,1705,1186,2891,1329,1504,2833,385,866,1251,6107,4814,10921
2021-06-23,9,9,18,5,4,9,39,30,69,115,54,169,318,156,474,786,312,1098,1422,697,2119,1708,1189,2897,1332,1507,2839,385,867,1252,6119,4825,10944
2021-06-24,9,9,18,5,4,9,39,30,69,116,54,170,319,156,475,789,315,1104,1426,699,2125,1708,1192,2900,1334,1511,2845,387,867,1254,6132,4837,10969
2021-06-25,9,9,18,5,4,9,39,30,69,116,54,170,321,156,477,790,315,1105,1430,700,2130,1708,1193,2901,1335,1513,2848,387,869,1256,6140,4843,10983
2021-06-26,10,9,19,5,4,9,39,30,69,117,54,171,322,156,478,795,315,1110,1433,700,2133,1710,1195,2905,1338,1516,2854,387,871,1258,6156,4850,11006
2021-06-27,10,9,19,5,4,9,39,30,69,117,54,171,324,156,480,795,315,1110,1435,701,2136,1712,1198,2910,1339,1517,2856,387,872,1259,6163,4856,11019
2021-06-28,10,9,19,5,4,9,39,30,69,117,54,171,325,156,481,796,315,1111,1438,702,2140,1715,1201,2916,1340,1519,2859,387,872,1259,6172,4862,11034
2021-06-29,10,9,19,5,4,9,39,30,69,117,54,171,326,156,482,797,316,1113,1439,703,2142,1719,1205,2924,1342,1523,2865,388,873,1261,6182,4873,11055
2021-06-30,10,9,19,5,4,9,39,30,69,118,54,172,326,156,482,797,317,1114,1440,705,2145,1721,1208,2929,1343,1524,2867,389,873,1262,6188,4880,11068
2021-07-01,10,9,19,5,4,9,39,30,69,118,54,172,327,156,483,797,318,1115,1442,705,2147,1721,1209,2930,1345,1526,2871,389,874,1263,6193,4885,11078
2021-07-02,10,9,19,5,4,9,39,30,69,118,54,172,328,156,484,798,318,1116,1446,705,2151,1723,1211,2934,1346,1526,2872,389,876,1265,6202,4889,11091
2021-07-03,10,9,19,5,4,9,39,30,69,118,54,172,328,156,484,800,318,1118,1446,705,2151,1725,1213,2938,1348,1529,2877,389,877,1266,6208,4895,11103
2021-07-04,10,9,19,5,4,9,39,30,69,118,54,172,328,156,484,802,318,1120,1447,705,2152,1727,1213,2940,1348,1530,2878,389,878,1267,6213,4897,11110
2021-07-05,10,9,19,5,4,9,39,30,69,118,54,172,329,157,486,803,319,1122,1449,706,2155,1728,1214,2942,1350,1531,2881,390,878,1268,6221,4902,11123
2021-07-06,10,9,19,5,4,9,40,30,70,118,54,172,329,157,486,804,320,1124,1450,706,2156,1730,1217,2947,1354,1533,2887,391,878,1269,6231,4908,11139
2021-07-07,10,9,19,5,4,9,40,30,70,118,54,172,329,157,486,807,320,1127,1451,706,2157,1733,1219,2952,1356,1533,2889,391,878,1269,6240,4910,11150
2021-07-08,10,9,19,5,4,9,40,30,70,119,54,173,330,157,487,808,320,1128,1451,708,2159,1737,1220,2957,1357,1535,2892,391,879,1270,6248,4916,11164
2021-07-09,10,9,19,5,4,9,40,30,70,119,54,173,330,157,487,808,320,1128,1451,708,2159,1737,1220,2957,1359,1535,2894,391,879,1270,6250,4916,11166
2021-07-10,10,9,19,5,4,9,40,30,70,120,54,174,330,158,488,808,320,1128,1451,708,2159,1737,1222,2959,1361,1536,2897,392,881,1273,6254,4922,11176
2021-07-11,10,9,19,5,4,9,40,30,70,120,54,174,330,158,488,808,321,1129,1453,708,2161,1738,1223,2961,1361,1536,2897,392,881,1273,6257,4924,11181
2021-07-12,10,9,19,5,4,9,40,30,70,120,54,174,331,159,490,809,321,1130,1456,708,2164,1744,1223,2967,1361,1536,2897,392,883,1275,6268,4927,11195
2021-07-13,10,9,19,5,4,9,40,30,70,121,54,175,331,160,491,810,322,1132,1461,709,2170,1748,1225,2973,1363,1538,2901,392,883,1275,6281,4934,11215
2021-07-14,10,9,19,5,4,9,40,30,70,121,54,175,331,160,491,813,323,1136,1461,710,2171,1748,1227,2975,1363,1542,2905,392,883,1275,6284,4942,11226
2021-07-15,10,9,19,5,4,9,40,30,70,121,54,175,331,160,491,813,324,1137,1462,710,2172,1750,1228,2978,1364,1542,2906,393,884,1277,6289,4945,11234
2021-07-16,10,9,19,5,4,9,40,30,70,121,54,175,332,160,492,814,324,1138,1462,710,2172,1751,1228,2979,1364,1545,2909,393,884,1277,6292,4948,11240
2021-07-17,10,9,19,5,4,9,40,30,70,121,54,175,333,160,493,816,324,1140,1463,711,2174,1752,1230,2982,1364,1546,2910,394,884,1278,6298,4952,11250
2021-07-18,10,9,19,5,4,9,40,30,70,121,54,175,333,160,493,816,324,1140,1463,711,2174,1752,1231,2983,1367,1547,2914,394,884,1278,6301,4954,11255
2021-07-19,11,10,21,5,4,9,40,30,70,121,54,175,333,161,494,816,324,1140,1465,711,2176,1752,1232,2984,1369,1547,2916,395,884,1279,6307,4957,11264
2021-07-20,11,10,21,5,4,9,40,30,70,121,54,175,333,162,495,816,324,1140,1465,711,2176,1753,1233,2986,1370,1548,2918,395,884,1279,6309,4960,11269
2021-07-21,11,10,21,5,4,9,40,30,70,121,54,175,333,162,495,817,325,1142,1465,711,2176,1756,1237,2993,1370,1548,2918,395,884,1279,6313,4965,11278
2021-07-22,11,10,21,5,4,9,40,30,70,121,54,175,333,162,495,819,325,1144,1467,712,2179,1758,1238,2996,1370,1548,2918,395,884,1279,6319,4967,11286
2021-07-23,11,10,21,5,4,9,40,30,70,121,54,175,334,162,496,819,326,1145,1468,713,2181,1762,1238,3000,1371,1549,2920,395,885,1280,6326,4971,11297
2021-07-24,11,10,21,5,4,9,40,31,71,121,54,175,334,162,496,819,326,1145,1469,713,2182,1763,1238,3001,1371,1549,2920,395,885,1280,6328,4972,11300
2021-07-25,11,10,21,5,4,9,40,31,71,121,54,175,335,162,497,819,326,1145,1469,713,2182,1764,1239,3003,1371,1549,2920,395,886,1281,6330,4974,11304
2021-07-26,11,10,21,5,4,9,41,31,72,121,54,175,336,162,498,819,326,1145,1470,713,2183,1768,1241,3009,1372,1550,2922,395,887,1282,6338,4978,11316
2021-07-27,11,10,21,5,4,9,42,31,73,121,54,175,336,162,498,820,327,1147,1470,713,2183,1770,1241,3011,1372,1550,2922,396,888,1284,6343,4980,11323
2021-07-28,11,10,21,5,4,9,42,31,73,121,54,175,336,162,498,820,327,1147,1470,713,2183,1770,1241,3011,1373,1551,2924,396,888,1284,6344,4981,11325
2021-07-29,11,10,21,5,4,9,42,31,73,121,54,175,336,162,498,821,327,1148,1470,713,2183,1770,1242,3012,1374,1552,2926,396,888,1284,6346,4983,11329
2021-07-30,11,10,21,5,4,9,42,31,73,121,54,175,336,162,498,821,327,1148,1473,714,2187,1770,1243,3013,1374,1552,2926,396,889,1285,6349,4986,11335
2021-07-31,11,10,21,5,4,9,42,31,73,121,54,175,336,163,499,821,327,1148,1473,714,2187,1772,1243,3015,1374,1553,2927,396,889,1285,6351,4988,11339
2021-08-01,11,10,21,5,4,9,42,31,73,121,54,175,336,163,499,821,327,1148,1473,714,2187,1772,1243,3015,1375,1554,2929,396,889,1285,6352,4989,11341
2021-08-02,11,10,21,5,4,9,42,31,73,121,54,175,336,163,499,821,327,1148,1474,714,2188,1772,1246,3018,1375,1558,2933,396,889,1285,6353,4996,11349
2021-08-03,11,10,21,5,4,9,42,31,73,121,54,175,336,163,499,821,327,1148,1474,714,2188,1774,1246,3020,1376,1558,2934,396,891,1287,6356,4998,11354
2021-08-04,11,10,21,5,4,9,42,31,73,121,54,175,337,163,500,821,327,1148,1475,714,2189,1774,1246,3020,1376,1559,2935,397,892,1289,6359,5000,11359
2021-08-05,11,10,21,5,4,9,42,31,73,121,54,175,337,163,500,822,327,1149,1475,714,2189,1774,1248,3022,1376,1561,2937,397,893,1290,6360,5005,11365
2021-08-06,11,10,21,5,4,9,42,31,73,121,54,175,337,163,500,822,327,1149,1476,714,2190,1774,1248,3022,1376,1561,2937,397,893,1290,6361,5005,11366
2021-08-07,11,10,21,5,4,9,42,31,73,121,54,175,337,163,500,822,327,1149,1478,716,2194,1774,1248,3022,1376,1563,2939,397,893,1290,6363,5009,11372
2021-08-08,11,10,21,5,4,9,42,31,73,121,54,175,337,163,500,822,327,1149,1478,716,2194,1774,1248,3022,1376,1563,2939,397,893,1290,6363,5009,11372
2021-08-09,11,10,21,6,4,10,42,31,73,121,54,175,337,163,500,822,327,1149,1478,717,2195,1774,1250,3024,1376,1564,2940,397,893,1290,6364,5013,11377
2021-08-10,11,10,21,6,4,10,42,31,73,121,54,175,337,163,500,823,327,1150,1478,717,2195,1774,1250,3024,1376,1564,2940,397,893,1290,6365,5013,11378
2021-08-11,11,10,21,6,4,10,42,31,73,121,54,175,338,163,501,823,327,1150,1478,717,2195,1775,1251,3026,1376,1567,2943,397,894,1291,6367,5018,11385
2021-08-12,11,10,21,6,4,10,42,31,73,121,54,175,338,163,501,823,327,1150,1478,718,2196,1776,1251,3027,1377,1568,2945,397,894,1291,6369,5020,11389
2021-08-13,11,10,21,6,4,10,42,31,73,121,54,175,338,163,501,823,327,1150,1478,718,2196,1776,1252,3028,1377,1569,2946,397,894,1291,6369,5022,11391
2021-08-14,11,10,21,6,4,10,42,31,73,121,54,175,338,163,501,823,327,1150,1478,718,2196,1778,1253,3031,1377,1569,2946,397,894,1291,6371,5023,11394
2021-08-15,11,10,21,6,4,10,42,31,73,121,54,175,339,163,502,823,328,1151,1478,718,2196,1778,1253,3031,1377,1569,2946,398,894,1292,6373,5024,11397
2021-08-16,11,10,21,6,4,10,42,31,73,121,54,175,339,164,503,823,328,1151,1478,718,2196,1778,1253,3031,1378,1569,2947,398,894,1292,6374,5025,11399
2021-08-17,11,10,21,6,4,10,42,31,73,121,54,175,339,164,503,823,328,1151,1478,718,2196,1778,1253,3031,1379,1569,2948,398,894,1292,6375,5025,11400
2021-08-18,11,10,21,6,4,10,42,31,73,121,54,175,339,164,503,823,328,1151,1478,718,2196,1778,1255,3033,1380,1569,2949,398,894,1292,6376,5027,11403
2021-08-19,11,10,21,6,4,10,42,32,74,121,54,175,339,164,503,823,328,1151,1478,718,2196,1778,1255,3033,1380,1569,2949,398,894,1292,6376,5028,11404
2021-08-20,11,10,21,6,4,10,42,32,74,121,54,175,339,164,503,823,328,1151,1478,718,2196,1778,1255,3033,1381,1569,2950,398,894,1292,6377,5028,11405
2021-08-21,11,10,21,6,4,10,42,32,74,121,54,175,339,164,503,823,328,1151,1478,718,2196,1778,1255,3033,1381,1569,2950,398,894,1292,6377,5028,11405
2021-08-22,11,10,21,6,4,10,42,32,74,121,54,175,339,164,503,823,328,1151,1478,718,2196,1778,1256,3034,1381,1569,2950,398,894,1292,6377,5029,11406
2021-08-23,11,10,21,6,4,10,42,32,74,121,54,175,339,164,503,823,328,1151,1478,718,2196,1778,1256,3034,1381,1569,2950,398,894,1292,6377,5029,11406
2021-08-24,11,10,21,6,4,10,42,32,74,121,54,175,339,165,504,823,328,1151,1478,718,2196,1778,1256,3034,1381,1569,2950,398,894,1292,6377,5030,11407
2021-08-25,11,10,21,6,4,10,42,32,74,121,54,175,339,165,504,823,328,1151,1478,718,2196,1778,1256,3034,1381,1569,2950,398,894,1292,6377,5030,11407
2021-08-26,11,10,21,6,4,10,42,32,74,121,54,175,339,165,504,823,328,1151,1478,718,2196,1778,1256,3034,1381,1569,2950,398,894,1292,6377,5030,11407
2021-08-27,11,10,21,6,4,10,42,32,74,121,54,175,339,165,504,823,328,1151,1478,718,2196,1778,1257,3035,1381,1569,2950,398,894,1292,6377,5031,11408
2021-08-28,11,10,21,6,4,10,42,32,74,121,54,175,339,165,504,823,328,1151,1478,718,2196,1779,1257,3036,1381,1569,2950,398,894,1292,6378,5031,11409
2021-08-29,11,10,21,6,4,10,42,32,74,121,54,175,339,165,504,823,328,1151,1478,718,2196,1779,1257,3036,1381,1569,2950,398,894,1292,6378,5031,11409
2021-08-30,11,10,21,6,4,10,42,32,74,121,54,175,339,165,504,823,329,1152,1478,718,2196,1779,1257,3036,1381,1569,2950,398,894,1292,6378,5032,11410
2021-08-31,11,10,21,6,4,10,42,32,74,121,54,175,339,165,504,823,329,1152,1478,718,2196,1779,1257,3036,1382,1569,2951,398,894,1292,6379,5032,11411
2021-09-01,11,10,21,6,4,10,42,32,74,121,54,175,339,165,504,823,329,1152,1478,718,2196,1779,1257,3036,1382,1569,2951,398,894,1292,6379,5032,11411
2021-09-02,11,10,21,6,4,10,42,32,74,121,54,175,339,165,504,823,329,1152,1478,718,2196,1779,1257,3036,1382,1569,2951,398,894,1292,6379,5032,11411
