FECHA,<=30M,<=30F,<=30,31-40M,31-40F,31-40,41-50M,41-50F,41-50,51-60M,51-60F,51-60,61-70M,61-70F,61-70,71-80M,71-80F,71-80,81-90M,81-90F,81-90,>=91M,>=91F,>=91,TotalM,TotalF,Total
2020-03-15,0,0,0,0,0,0,0,0,0,0,0,0,0,0,0,0,0,0,0,0,0,0,0,0,0,0,0
2020-03-16,0,0,0,0,0,0,0,0,0,0,0,0,0,0,0,0,0,0,0,0,0,0,0,0,0,0,0
2020-03-17,0,0,0,0,0,0,0,0,0,0,0,0,0,0,0,1,0,1,0,0,0,0,0,0,1,0,1
2020-03-18,0,0,0,0,0,0,0,0,0,0,0,0,0,0,0,1,0,1,0,0,0,0,0,0,1,0,1
2020-03-19,0,0,0,0,0,0,0,0,0,0,0,0,0,0,0,1,0,1,0,0,0,0,0,0,1,0,1
2020-03-20,0,0,0,0,0,0,0,0,0,0,0,0,0,0,0,1,0,1,0,1,1,0,0,0,1,1,2
2020-03-21,0,0,0,0,0,0,0,0,0,0,0,0,1,0,1,3,0,3,0,1,1,0,0,0,4,1,5
2020-03-22,0,0,0,0,0,0,0,0,0,0,0,0,1,0,1,4,0,4,0,1,1,0,0,0,5,1,6
2020-03-23,0,0,0,0,0,0,0,0,0,0,0,0,1,0,1,4,0,4,0,1,1,0,0,0,5,1,6
2020-03-24,0,0,0,0,0,0,0,0,0,0,0,0,1,0,1,4,1,5,0,1,1,0,0,0,5,2,7
2020-03-25,0,0,0,0,0,0,0,0,0,0,0,0,2,0,2,4,1,5,1,3,4,0,1,1,7,5,12
2020-03-26,0,0,0,0,0,0,0,0,0,1,0,1,4,0,4,4,1,5,1,3,4,0,1,1,10,5,15
2020-03-27,0,0,0,0,0,0,0,0,0,2,0,2,5,0,5,4,1,5,1,3,4,0,1,1,12,5,17
2020-03-28,0,0,0,0,0,0,0,0,0,2,0,2,5,0,5,4,1,5,3,3,6,0,1,1,14,5,19
2020-03-29,0,0,0,0,0,0,0,0,0,2,0,2,5,0,5,4,1,5,3,3,6,0,1,1,14,5,19
2020-03-30,0,0,0,0,0,0,1,0,1,2,0,2,6,0,6,6,1,7,3,3,6,0,2,2,18,6,24
2020-03-31,0,0,0,0,0,0,1,0,1,3,0,3,6,0,6,8,2,10,3,4,7,0,2,2,21,8,29
2020-04-01,0,0,0,0,0,0,1,0,1,3,0,3,8,0,8,8,2,10,3,4,7,0,2,2,23,8,31
2020-04-02,0,0,0,0,0,0,1,0,1,3,0,3,8,0,8,10,2,12,3,4,7,1,3,4,26,9,35
2020-04-03,0,0,0,0,0,0,1,0,1,3,1,4,8,1,9,11,2,13,3,5,8,1,3,4,27,12,39
2020-04-04,0,0,0,0,0,0,1,0,1,3,1,4,8,1,9,11,2,13,3,5,8,2,3,5,28,12,40
2020-04-05,0,0,0,0,0,0,1,1,2,3,1,4,8,1,9,13,2,15,3,5,8,2,3,5,30,13,43
2020-04-06,0,0,0,0,0,0,1,1,2,3,1,4,9,1,10,13,3,16,3,5,8,2,3,5,31,14,45
2020-04-07,0,0,0,0,0,0,1,1,2,3,1,4,9,1,10,13,5,18,3,5,8,3,3,6,32,16,48
2020-04-08,0,0,0,0,0,0,1,1,2,4,1,5,9,1,10,14,6,20,3,5,8,3,3,6,34,17,51
2020-04-09,0,0,0,0,0,0,1,1,2,4,1,5,9,1,10,14,6,20,3,5,8,3,3,6,34,17,51
2020-04-10,0,0,0,0,0,0,1,1,2,4,1,5,9,1,10,14,6,20,3,5,8,3,3,6,34,17,51
2020-04-11,0,0,0,0,0,0,1,1,2,4,1,5,9,1,10,14,6,20,5,5,10,3,3,6,36,17,53
2020-04-12,0,0,0,0,0,0,1,1,2,4,1,5,9,1,10,14,6,20,5,5,10,3,3,6,36,17,53
2020-04-13,0,0,0,0,0,0,1,1,2,4,1,5,9,1,10,14,6,20,5,5,10,3,3,6,36,17,53
2020-04-14,0,0,0,0,0,0,1,1,2,4,1,5,10,1,11,16,7,23,5,5,10,3,3,6,39,18,57
2020-04-15,0,0,0,0,0,0,1,1,2,4,1,5,10,1,11,16,7,23,5,5,10,3,3,6,39,18,57
2020-04-16,0,0,0,0,0,0,1,1,2,4,1,5,10,1,11,16,7,23,5,5,10,3,3,6,39,18,57
2020-04-17,1,0,1,0,0,0,1,1,2,4,1,5,10,1,11,16,8,24,7,8,15,3,4,7,42,23,65
2020-04-18,1,0,1,0,0,0,2,1,3,4,1,5,10,1,11,16,9,25,8,10,18,3,6,9,44,28,72
2020-04-19,1,0,1,0,0,0,2,1,3,4,1,5,10,1,11,16,9,25,9,10,19,3,6,9,45,28,73
2020-04-20,1,0,1,0,0,0,3,1,4,4,1,5,10,1,11,16,9,25,10,10,20,3,7,10,47,29,76
2020-04-21,1,0,1,0,0,0,3,1,4,5,1,6,11,1,12,16,9,25,12,10,22,4,10,14,52,32,84
2020-04-22,1,0,1,1,0,1,3,1,4,5,1,6,12,1,13,17,12,29,13,12,25,5,13,18,57,40,97
2020-04-23,1,0,1,1,0,1,3,1,4,5,1,6,13,2,15,19,14,33,16,12,28,5,16,21,63,46,109
2020-04-24,1,0,1,1,0,1,3,1,4,5,1,6,13,2,15,19,14,33,18,14,32,5,16,21,65,48,113
2020-04-25,1,0,1,1,0,1,4,1,5,5,1,6,13,2,15,19,14,33,18,16,34,5,16,21,66,50,116
2020-04-26,1,0,1,1,0,1,4,1,5,5,1,6,13,2,15,19,14,33,18,16,34,5,16,21,66,50,116
2020-04-27,1,0,1,1,0,1,4,1,5,5,1,6,14,2,16,20,14,34,21,17,38,5,17,22,71,52,123
2020-04-28,1,0,1,1,0,1,4,1,5,5,1,6,14,2,16,20,14,34,22,19,41,5,17,22,72,54,126
2020-04-29,1,0,1,1,0,1,4,1,5,5,1,6,14,2,16,21,14,35,22,19,41,5,17,22,73,54,127
2020-04-30,1,0,1,1,0,1,4,1,5,6,1,7,14,2,16,21,14,35,22,19,41,5,17,22,74,54,128
2020-05-01,1,0,1,1,0,1,4,1,5,7,1,8,14,2,16,21,14,35,22,20,42,6,17,23,76,55,131
2020-05-02,1,0,1,1,0,1,4,1,5,7,1,8,14,2,16,22,14,36,22,20,42,6,17,23,77,55,132
2020-05-03,1,0,1,1,0,1,4,1,5,8,1,9,15,2,17,22,14,36,23,20,43,6,17,23,80,55,135
2020-05-04,1,0,1,1,0,1,4,1,5,9,1,10,15,2,17,22,14,36,23,22,45,6,17,23,81,57,138
2020-05-05,1,0,1,2,0,2,4,2,6,9,1,10,15,2,17,23,14,37,26,22,48,6,19,25,86,60,146
2020-05-06,1,0,1,2,0,2,5,2,7,9,1,10,17,3,20,23,14,37,27,23,50,7,20,27,91,63,154
2020-05-07,1,0,1,2,0,2,5,2,7,11,1,12,17,3,20,23,15,38,28,23,51,7,22,29,94,66,160
2020-05-08,1,0,1,2,0,2,5,2,7,11,1,12,17,3,20,23,15,38,28,24,52,7,22,29,94,67,161
2020-05-09,1,0,1,2,0,2,5,2,7,11,1,12,17,4,21,23,15,38,28,24,52,8,22,30,95,68,163
2020-05-10,1,0,1,2,0,2,5,2,7,11,1,12,18,4,22,23,15,38,28,24,52,8,22,30,96,68,164
2020-05-11,1,0,1,2,0,2,6,3,9,11,1,12,19,4,23,23,15,38,28,24,52,8,22,30,98,69,167
2020-05-12,1,0,1,3,0,3,6,3,9,13,2,15,21,5,26,24,18,42,28,25,53,9,23,32,105,76,181
2020-05-13,1,0,1,4,0,4,6,3,9,13,3,16,23,5,28,24,18,42,28,26,54,9,25,34,108,80,188
2020-05-14,1,0,1,4,0,4,6,3,9,15,3,18,24,5,29,25,19,44,28,27,55,9,25,34,112,82,194
2020-05-15,1,0,1,4,0,4,6,4,10,15,3,18,24,5,29,25,20,45,28,28,56,10,26,36,113,86,199
2020-05-16,1,0,1,5,0,5,6,5,11,16,3,19,24,6,30,27,21,48,28,29,57,10,29,39,117,93,210
2020-05-17,1,1,2,5,0,5,6,6,12,19,3,22,25,6,31,28,22,50,30,31,61,10,29,39,124,98,222
2020-05-18,1,1,2,6,0,6,7,6,13,21,3,24,27,7,34,30,23,53,30,31,61,10,29,39,132,100,232
2020-05-19,1,1,2,6,0,6,8,6,14,22,3,25,27,7,34,30,23,53,30,33,63,11,29,40,135,102,237
2020-05-20,1,2,3,7,0,7,8,7,15,25,4,29,28,7,35,31,24,55,32,35,67,11,29,40,143,108,251
2020-05-21,1,2,3,7,0,7,9,7,16,25,4,29,30,7,37,31,25,56,32,36,68,11,32,43,146,113,259
2020-05-22,1,2,3,7,0,7,9,7,16,28,4,32,31,9,40,31,25,56,32,36,68,11,32,43,150,115,265
2020-05-23,1,2,3,7,0,7,12,7,19,30,4,34,32,9,41,31,25,56,34,40,74,11,33,44,158,120,278
2020-05-24,1,2,3,8,0,8,12,7,19,30,5,35,33,9,42,31,26,57,34,40,74,12,33,45,161,122,283
2020-05-25,1,2,3,8,0,8,12,8,20,31,5,36,34,11,45,32,30,62,35,41,76,13,33,46,166,130,296
2020-05-26,1,2,3,8,0,8,12,8,20,35,7,42,36,12,48,33,31,64,35,44,79,15,33,48,175,137,312
2020-05-27,1,2,3,8,0,8,14,9,23,35,7,42,37,12,49,36,34,70,36,46,82,15,34,49,182,144,326
2020-05-28,1,2,3,10,0,10,14,10,24,37,9,46,38,12,50,37,40,77,40,51,91,18,42,60,195,166,361
2020-05-29,1,2,3,10,0,10,16,11,27,37,9,46,40,12,52,39,43,82,42,57,99,18,44,62,203,178,381
2020-05-30,1,2,3,10,0,10,17,11,28,40,9,49,40,12,52,41,44,85,43,57,100,19,44,63,211,179,390
2020-05-31,1,2,3,10,0,10,18,11,29,41,11,52,40,12,52,45,45,90,46,59,105,20,44,64,221,184,405
2020-06-01,1,2,3,11,0,11,18,12,30,43,11,54,40,13,53,46,46,92,49,61,110,20,44,64,228,189,417
2020-06-02,2,2,4,11,0,11,19,14,33,44,12,56,46,13,59,48,48,96,50,63,113,22,47,69,242,199,441
2020-06-03,2,2,4,11,0,11,20,15,35,48,13,61,50,14,64,51,49,100,51,64,115,22,47,69,255,204,459
2020-06-04,2,2,4,12,0,12,20,15,35,49,14,63,53,15,68,54,52,106,51,66,117,25,51,76,266,215,481
2020-06-05,2,3,5,12,0,12,20,15,35,50,15,65,57,17,74,59,57,116,53,69,122,25,53,78,278,229,507
2020-06-06,2,3,5,12,0,12,20,15,35,53,15,68,57,17,74,62,58,120,54,75,129,26,56,82,286,239,525
2020-06-07,2,3,5,12,0,12,20,15,35,55,15,70,58,17,75,62,60,122,57,80,137,26,58,84,292,248,540
2020-06-08,2,3,5,14,0,14,22,15,37,56,15,71,58,18,76,67,63,130,62,80,142,26,60,86,307,254,561
2020-06-09,2,3,5,15,1,16,22,16,38,58,15,73,58,21,79,69,63,132,64,82,146,26,63,89,314,264,578
2020-06-10,2,3,5,15,1,16,22,17,39,60,16,76,60,22,82,73,64,137,65,90,155,27,66,93,324,279,603
2020-06-11,2,3,5,15,1,16,24,17,41,64,16,80,63,24,87,75,67,142,66,93,159,27,69,96,336,290,626
2020-06-12,2,3,5,16,1,17,25,17,42,68,17,85,64,26,90,82,67,149,69,93,162,28,71,99,354,295,649
2020-06-13,2,4,6,16,1,17,25,19,44,70,18,88,67,26,93,84,71,155,70,98,168,28,75,103,362,312,674
2020-06-14,2,4,6,16,1,17,26,19,45,70,19,89,70,26,96,86,72,158,72,102,174,28,77,105,370,320,690
2020-06-15,2,4,6,16,1,17,26,20,46,70,19,89,73,27,100,86,76,162,72,103,175,31,77,108,376,327,703
2020-06-16,3,4,7,17,1,18,27,20,47,74,19,93,75,30,105,94,78,172,73,105,178,31,80,111,394,337,731
2020-06-17,5,4,9,17,1,18,28,20,48,74,22,96,80,31,111,102,80,182,75,110,185,32,82,114,413,350,763
2020-06-18,5,4,9,19,2,21,31,20,51,77,23,100,82,32,114,103,82,185,80,111,191,33,83,116,430,357,787
2020-06-19,5,4,9,20,2,22,31,20,51,79,25,104,86,36,122,108,86,194,86,112,198,33,91,124,448,376,824
2020-06-20,5,4,9,21,2,23,31,20,51,81,26,107,87,40,127,115,90,205,89,115,204,35,94,129,464,391,855
2020-06-21,5,4,9,21,3,24,32,21,53,82,26,108,91,41,132,118,92,210,90,119,209,35,99,134,474,405,879
2020-06-22,5,5,10,22,3,25,34,21,55,82,27,109,96,46,142,124,95,219,98,125,223,36,100,136,497,422,919
2020-06-23,5,5,10,23,3,26,35,21,56,86,28,114,97,48,145,130,96,226,106,132,238,39,103,142,521,436,957
2020-06-24,5,5,10,23,3,26,35,23,58,88,29,117,100,50,150,135,97,232,111,136,247,40,109,149,537,452,989
2020-06-25,5,5,10,23,3,26,37,24,61,91,29,120,107,55,162,137,99,236,116,144,260,41,113,154,557,472,1029
2020-06-26,5,5,10,23,3,26,37,26,63,94,30,124,109,57,166,143,99,242,118,148,266,42,116,158,571,484,1055
2020-06-27,5,5,10,23,3,26,38,26,64,95,31,126,113,59,172,144,101,245,121,151,272,44,119,163,583,495,1078
2020-06-28,5,5,10,23,3,26,38,26,64,95,31,126,113,60,173,146,103,249,126,158,284,45,123,168,591,509,1100
2020-06-29,5,6,11,23,3,26,38,26,64,97,31,128,116,62,178,150,108,258,136,165,301,46,126,172,611,527,1138
2020-06-30,5,6,11,23,3,26,39,27,66,101,34,135,125,65,190,157,113,270,141,173,314,48,134,182,639,555,1194
2020-07-01,5,6,11,23,3,26,40,28,68,103,35,138,128,65,193,160,115,275,153,177,330,50,137,187,662,566,1228
2020-07-02,5,6,11,23,4,27,42,28,70,105,35,140,134,67,201,166,119,285,157,180,337,50,140,190,682,579,1261
2020-07-03,5,6,11,23,5,28,42,29,71,107,35,142,139,68,207,171,125,296,159,192,351,51,142,193,697,602,1299
2020-07-04,5,7,12,23,6,29,43,30,73,108,36,144,142,70,212,174,132,306,163,204,367,52,149,201,710,634,1344
2020-07-05,5,8,13,23,7,30,43,30,73,112,37,149,145,75,220,176,137,313,168,214,382,54,153,207,726,661,1387
2020-07-06,5,8,13,23,7,30,45,30,75,115,38,153,151,78,229,185,145,330,177,228,405,59,162,221,760,696,1456
2020-07-07,5,8,13,24,7,31,45,30,75,117,38,155,162,79,241,195,152,347,186,236,422,62,167,229,796,717,1513
2020-07-08,5,8,13,24,7,31,47,31,78,118,41,159,168,80,248,202,160,362,191,241,432,66,174,240,821,742,1563
2020-07-09,5,9,14,24,7,31,48,32,80,118,41,159,171,81,252,210,164,374,196,251,447,68,178,246,840,763,1603
2020-07-10,5,10,15,25,7,32,48,32,80,121,44,165,176,84,260,217,172,389,208,260,468,68,183,251,868,792,1660
2020-07-11,5,11,16,27,7,34,48,32,80,122,44,166,182,84,266,220,174,394,210,268,478,69,189,258,883,809,1692
2020-07-12,6,11,17,27,8,35,52,32,84,124,44,168,186,84,270,225,179,404,222,275,497,69,194,263,911,827,1738
2020-07-13,6,11,17,27,8,35,52,33,85,125,47,172,192,84,276,232,188,420,230,280,510,71,205,276,935,856,1791
2020-07-14,6,11,17,27,8,35,53,33,86,128,51,179,200,86,286,246,191,437,233,291,524,76,213,289,969,884,1853
2020-07-15,6,12,18,28,9,37,56,33,89,129,51,180,208,87,295,257,196,453,240,302,542,78,219,297,1002,909,1911
2020-07-16,6,12,18,29,9,38,56,33,89,130,51,181,215,89,304,267,200,467,250,313,563,83,226,309,1036,933,1969
2020-07-17,7,12,19,29,10,39,59,33,92,134,52,186,225,91,316,272,205,477,263,324,587,85,239,324,1074,966,2040
2020-07-18,8,13,21,29,10,39,61,34,95,135,53,188,228,91,319,278,213,491,267,331,598,87,244,331,1093,989,2082
2020-07-19,8,13,21,29,10,39,62,34,96,136,54,190,230,91,321,282,215,497,276,343,619,92,248,340,1115,1008,2123
2020-07-20,8,13,21,30,12,42,64,34,98,138,57,195,239,92,331,287,223,510,287,350,637,93,250,343,1146,1031,2177
2020-07-21,11,13,24,30,12,42,66,34,100,140,57,197,252,97,349,296,226,522,294,363,657,94,259,353,1183,1061,2244
2020-07-22,11,13,24,30,12,42,66,34,100,143,57,200,258,99,357,305,232,537,301,370,671,97,267,364,1211,1084,2295
2020-07-23,11,13,24,30,13,43,67,34,101,146,59,205,265,100,365,309,239,548,307,381,688,97,270,367,1232,1109,2341
2020-07-24,11,13,24,30,13,43,70,34,104,149,60,209,271,102,373,314,243,557,315,396,711,99,274,373,1259,1135,2394
2020-07-25,11,14,25,30,13,43,71,34,105,150,63,213,276,102,378,316,247,563,321,403,724,104,285,389,1279,1161,2440
2020-07-26,12,14,26,31,13,44,73,35,108,150,63,213,279,102,381,321,253,574,332,410,742,105,290,395,1303,1180,2483
2020-07-27,12,14,26,31,14,45,74,36,110,155,66,221,280,105,385,324,259,583,344,415,759,107,295,402,1327,1204,2531
2020-07-28,12,15,27,31,14,45,75,37,112,157,68,225,286,108,394,332,267,599,355,426,781,107,300,407,1355,1235,2590
2020-07-29,12,15,27,32,15,47,76,38,114,159,69,228,291,108,399,337,270,607,360,432,792,111,301,412,1378,1248,2626
2020-07-30,12,15,27,32,15,47,80,41,121,159,69,228,293,109,402,342,274,616,364,441,805,113,306,419,1395,1270,2665
2020-07-31,12,16,28,32,15,47,82,43,125,161,71,232,297,111,408,348,280,628,367,448,815,114,317,431,1413,1301,2714
2020-08-01,12,16,28,32,15,47,84,44,128,163,72,235,300,113,413,351,284,635,373,454,827,116,322,438,1431,1320,2751
2020-08-02,12,16,28,33,15,48,85,45,130,165,72,237,303,115,418,359,290,649,377,467,844,117,326,443,1451,1346,2797
2020-08-03,13,16,29,33,15,48,86,46,132,168,73,241,311,118,429,369,298,667,382,481,863,118,338,456,1480,1385,2865
2020-08-04,13,17,30,33,15,48,87,47,134,171,76,247,319,121,440,376,302,678,391,492,883,120,349,469,1510,1419,2929
2020-08-05,13,18,31,33,15,48,88,48,136,174,80,254,327,123,450,382,307,689,402,507,909,121,356,477,1540,1454,2994
2020-08-06,13,18,31,35,15,50,90,48,138,178,81,259,330,125,455,386,313,699,410,515,925,124,363,487,1566,1478,3044
2020-08-07,13,18,31,36,15,51,91,50,141,179,81,260,331,128,459,389,318,707,419,520,939,127,365,492,1585,1495,3080
2020-08-08,13,18,31,37,15,52,91,51,142,180,83,263,336,131,467,394,321,715,425,528,953,128,368,496,1604,1515,3119
2020-08-09,13,18,31,37,15,52,91,52,143,183,84,267,344,136,480,399,324,723,432,533,965,131,368,499,1630,1530,3160
2020-08-10,13,18,31,38,15,53,92,53,145,184,88,272,349,139,488,404,328,732,437,542,979,131,373,504,1648,1556,3204
2020-08-11,13,18,31,39,15,54,93,53,146,185,88,273,354,143,497,409,332,741,441,551,992,133,375,508,1667,1575,3242
2020-08-12,14,18,32,39,15,54,94,53,147,186,90,276,355,147,502,415,335,750,443,556,999,135,378,513,1681,1592,3273
2020-08-13,14,18,32,39,15,54,94,53,147,186,93,279,361,149,510,423,338,761,449,563,1012,136,378,514,1702,1607,3309
2020-08-14,14,18,32,39,15,54,96,53,149,186,93,279,366,151,517,427,339,766,455,568,1023,136,380,516,1719,1617,3336
2020-08-15,14,19,33,39,15,54,97,53,150,187,93,280,371,154,525,437,344,781,462,578,1040,136,388,524,1743,1644,3387
2020-08-16,14,19,33,39,15,54,99,53,152,187,94,281,375,154,529,441,347,788,469,584,1053,136,394,530,1760,1660,3420
2020-08-17,14,19,33,39,16,55,100,53,153,190,95,285,379,155,534,445,349,794,471,589,1060,136,396,532,1774,1672,3446
2020-08-18,16,19,35,39,16,55,100,53,153,192,96,288,383,156,539,453,352,805,474,607,1081,138,401,539,1795,1700,3495
2020-08-19,17,20,37,39,16,55,101,53,154,195,97,292,394,157,551,457,361,818,483,616,1099,143,403,546,1829,1723,3552
2020-08-20,17,20,37,40,16,56,102,53,155,195,97,292,405,158,563,462,367,829,492,620,1112,145,410,555,1858,1741,3599
2020-08-21,17,21,38,40,16,56,104,53,157,196,97,293,414,158,572,463,374,837,495,629,1124,147,415,562,1876,1763,3639
2020-08-22,17,21,38,40,16,56,106,53,159,196,97,293,420,160,580,468,377,845,501,633,1134,148,417,565,1896,1774,3670
2020-08-23,17,21,38,41,16,57,106,53,159,199,98,297,424,163,587,474,378,852,512,639,1151,151,421,572,1924,1789,3713
2020-08-24,17,21,38,42,16,58,107,53,160,201,98,299,429,169,598,478,383,861,517,641,1158,153,426,579,1944,1807,3751
2020-08-25,17,21,38,44,16,60,109,53,162,204,99,303,431,176,607,489,389,878,525,652,1177,155,429,584,1974,1835,3809
2020-08-26,17,21,38,44,18,62,109,55,164,206,100,306,436,177,613,495,394,889,532,664,1196,156,434,590,1995,1863,3858
2020-08-27,17,21,38,45,18,63,110,56,166,210,100,310,438,179,617,504,394,898,538,676,1214,160,438,598,2022,1882,3904
2020-08-28,17,21,38,45,18,63,111,56,167,215,100,315,441,182,623,512,396,908,543,684,1227,160,438,598,2044,1895,3939
2020-08-29,17,21,38,47,18,65,111,57,168,217,100,317,444,183,627,517,401,918,550,684,1234,160,441,601,2063,1905,3968
2020-08-30,17,21,38,48,18,66,111,58,169,220,100,320,451,183,634,524,406,930,554,688,1242,162,444,606,2087,1918,4005
2020-08-31,17,21,38,48,18,66,112,58,170,223,101,324,458,184,642,537,410,947,562,694,1256,162,445,607,2119,1931,4050
2020-09-01,17,21,38,48,18,66,113,58,171,224,101,325,465,185,650,545,414,959,567,704,1271,165,449,614,2144,1950,4094
2020-09-02,17,21,38,48,18,66,113,59,172,227,105,332,470,186,656,549,418,967,576,711,1287,165,452,617,2165,1970,4135
2020-09-03,17,21,38,48,18,66,114,61,175,229,106,335,475,186,661,556,426,982,585,716,1301,166,457,623,2190,1991,4181
2020-09-04,17,22,39,48,19,67,116,61,177,230,108,338,476,188,664,558,432,990,586,720,1306,167,459,626,2198,2009,4207
2020-09-05,17,22,39,48,19,67,116,62,178,232,109,341,481,192,673,567,435,1002,589,730,1319,167,461,628,2217,2030,4247
2020-09-06,17,22,39,48,19,67,117,62,179,235,109,344,484,192,676,576,439,1015,591,736,1327,170,464,634,2238,2043,4281
2020-09-07,17,22,39,48,19,67,118,63,181,238,110,348,487,197,684,585,445,1030,601,743,1344,171,469,640,2265,2068,4333
2020-09-08,17,22,39,48,19,67,118,63,181,240,111,351,492,201,693,595,450,1045,609,753,1362,174,473,647,2293,2092,4385
2020-09-09,18,22,40,48,19,67,119,64,183,246,112,358,498,204,702,602,454,1056,612,758,1370,176,479,655,2319,2112,4431
2020-09-10,18,23,41,48,19,67,119,64,183,247,112,359,502,207,709,614,456,1070,614,765,1379,177,485,662,2339,2131,4470
2020-09-11,18,23,41,49,19,68,120,65,185,248,112,360,507,209,716,618,461,1079,617,773,1390,177,486,663,2354,2148,4502
2020-09-12,18,23,41,49,19,68,120,65,185,249,114,363,509,213,722,622,462,1084,621,777,1398,177,492,669,2365,2165,4530
2020-09-13,18,23,41,49,19,68,121,65,186,249,114,363,513,215,728,627,464,1091,621,781,1402,177,493,670,2375,2174,4549
2020-09-14,20,23,43,49,19,68,121,65,186,251,114,365,516,216,732,633,470,1103,626,785,1411,178,495,673,2394,2187,4581
2020-09-15,20,23,43,49,19,68,121,65,186,253,116,369,519,217,736,638,472,1110,632,788,1420,179,498,677,2411,2198,4609
2020-09-16,21,23,44,50,19,69,121,65,186,253,117,370,524,219,743,641,476,1117,635,794,1429,180,502,682,2425,2215,4640
2020-09-17,21,23,44,50,19,69,121,65,186,253,117,370,527,220,747,648,478,1126,639,798,1437,181,506,687,2440,2226,4666
2020-09-18,22,24,46,51,19,70,121,67,188,253,117,370,530,221,751,649,482,1131,644,802,1446,181,509,690,2451,2241,4692
2020-09-19,22,24,46,51,19,70,121,67,188,254,118,372,532,223,755,653,484,1137,646,807,1453,181,512,693,2460,2254,4714
2020-09-20,22,24,46,51,19,70,124,67,191,255,118,373,535,224,759,654,487,1141,648,809,1457,181,514,695,2470,2262,4732
2020-09-21,22,24,46,51,19,70,125,67,192,255,118,373,537,224,761,660,491,1151,649,814,1463,181,515,696,2480,2272,4752
2020-09-22,22,24,46,51,19,70,125,67,192,256,119,375,539,227,766,663,492,1155,654,819,1473,182,518,700,2492,2285,4777
2020-09-23,22,24,46,51,19,70,125,68,193,260,119,379,541,230,771,668,496,1164,656,823,1479,183,520,703,2506,2299,4805
2020-09-24,22,24,46,51,19,70,125,68,193,262,120,382,544,230,774,669,498,1167,661,828,1489,184,521,705,2518,2308,4826
2020-09-25,22,24,46,51,20,71,125,69,194,264,120,384,548,231,779,675,505,1180,663,831,1494,186,527,713,2534,2327,4861
2020-09-26,22,24,46,51,20,71,125,69,194,264,120,384,549,232,781,680,507,1187,667,835,1502,187,527,714,2545,2334,4879
2020-09-27,22,24,46,51,20,71,125,69,194,264,120,384,551,233,784,684,511,1195,670,839,1509,188,529,717,2555,2345,4900
2020-09-28,22,24,46,51,20,71,125,71,196,266,120,386,557,234,791,687,512,1199,678,841,1519,189,529,718,2575,2351,4926
2020-09-29,22,24,46,52,20,72,125,71,196,267,120,387,562,235,797,689,516,1205,682,846,1528,189,531,720,2588,2363,4951
2020-09-30,23,24,47,52,20,72,125,72,197,267,120,387,567,237,804,694,516,1210,686,850,1536,191,534,725,2605,2373,4978
2020-10-01,24,24,48,52,20,72,126,72,198,268,120,388,573,241,814,697,520,1217,688,853,1541,192,536,728,2620,2386,5006
2020-10-02,24,24,48,52,20,72,126,73,199,269,120,389,576,243,819,700,526,1226,690,856,1546,194,538,732,2631,2400,5031
2020-10-03,25,24,49,52,20,72,126,73,199,269,120,389,577,243,820,704,526,1230,690,858,1548,195,538,733,2638,2402,5040
2020-10-04,25,24,49,52,20,72,128,73,201,270,120,390,578,243,821,706,528,1234,693,859,1552,195,539,734,2647,2406,5053
2020-10-05,25,24,49,52,20,72,130,73,203,271,120,391,581,245,826,709,531,1240,696,864,1560,195,541,736,2659,2418,5077
2020-10-06,25,24,49,52,20,72,130,74,204,271,120,391,582,246,828,711,532,1243,703,866,1569,196,541,737,2670,2423,5093
2020-10-07,25,24,49,52,20,72,130,74,204,271,120,391,583,246,829,712,537,1249,707,870,1577,196,542,738,2676,2433,5109
2020-10-08,25,24,49,52,20,72,130,74,204,271,120,391,586,247,833,715,544,1259,712,875,1587,197,544,741,2688,2448,5136
2020-10-09,25,24,49,52,20,72,131,74,205,274,121,395,589,248,837,719,545,1264,717,879,1596,197,545,742,2704,2456,5160
2020-10-10,25,24,49,52,20,72,133,74,207,274,121,395,591,248,839,723,548,1271,720,881,1601,197,545,742,2715,2461,5176
2020-10-11,25,24,49,53,20,73,134,75,209,275,121,396,591,249,840,725,551,1276,722,882,1604,198,545,743,2723,2467,5190
2020-10-12,25,24,49,53,20,73,135,75,210,277,121,398,592,250,842,728,552,1280,724,884,1608,198,545,743,2732,2471,5203
2020-10-13,25,24,49,53,20,73,135,75,210,280,121,401,596,252,848,731,553,1284,727,890,1617,198,545,743,2745,2480,5225
2020-10-14,26,24,50,53,20,73,136,75,211,282,121,403,597,253,850,734,557,1291,730,893,1623,199,547,746,2757,2490,5247
2020-10-15,26,24,50,53,20,73,138,75,213,282,123,405,598,254,852,737,558,1295,733,896,1629,199,548,747,2766,2498,5264
2020-10-16,26,24,50,53,20,73,139,75,214,283,123,406,601,256,857,739,559,1298,737,899,1636,200,554,754,2778,2510,5288
2020-10-17,26,25,51,53,20,73,139,77,216,283,124,407,604,257,861,742,560,1302,742,899,1641,201,556,757,2790,2518,5308
2020-10-18,27,25,52,54,20,74,139,77,216,284,124,408,604,258,862,744,561,1305,742,900,1642,201,557,758,2795,2522,5317
2020-10-19,27,26,53,54,20,74,140,77,217,284,124,408,604,259,863,747,564,1311,742,903,1645,201,557,758,2799,2530,5329
2020-10-20,27,26,53,55,20,75,140,78,218,285,124,409,605,260,865,749,565,1314,748,905,1653,202,557,759,2811,2535,5346
2020-10-21,27,26,53,55,20,75,140,78,218,286,125,411,608,262,870,751,565,1316,749,905,1654,202,557,759,2818,2538,5356
2020-10-22,27,26,53,55,20,75,140,78,218,287,125,412,608,263,871,753,567,1320,750,906,1656,202,557,759,2822,2542,5364
2020-10-23,27,26,53,55,20,75,140,78,218,288,125,413,611,265,876,755,571,1326,753,909,1662,203,558,761,2832,2552,5384
2020-10-24,27,26,53,55,20,75,140,78,218,290,125,415,613,265,878,756,574,1330,753,911,1664,203,559,762,2837,2558,5395
2020-10-25,27,26,53,56,20,76,140,78,218,290,125,415,614,266,880,757,574,1331,754,913,1667,203,560,763,2841,2562,5403
2020-10-26,27,26,53,56,20,76,140,78,218,291,125,416,618,266,884,759,577,1336,758,916,1674,205,561,766,2854,2569,5423
2020-10-27,27,26,53,56,20,76,140,79,219,294,126,420,619,267,886,761,579,1340,761,919,1680,206,561,767,2864,2577,5441
2020-10-28,28,26,54,56,20,76,140,79,219,295,126,421,621,267,888,762,579,1341,764,920,1684,207,562,769,2873,2579,5452
2020-10-29,28,26,54,57,20,77,140,79,219,295,127,422,622,267,889,764,579,1343,766,921,1687,207,562,769,2879,2581,5460
2020-10-30,28,26,54,57,20,77,140,79,219,295,128,423,624,268,892,765,579,1344,768,922,1690,208,563,771,2885,2585,5470
2020-10-31,28,26,54,57,20,77,140,79,219,295,128,423,625,268,893,766,580,1346,768,922,1690,208,563,771,2887,2586,5473
2020-11-01,28,26,54,57,20,77,140,79,219,295,128,423,625,268,893,766,581,1347,770,923,1693,208,563,771,2889,2588,5477
2020-11-02,28,26,54,57,20,77,140,79,219,296,128,424,625,268,893,766,581,1347,770,923,1693,208,564,772,2890,2589,5479
2020-11-03,28,26,54,57,20,77,140,79,219,296,128,424,625,269,894,767,584,1351,770,925,1695,208,565,773,2891,2596,5487
2020-11-04,28,26,54,57,20,77,140,79,219,296,129,425,626,269,895,768,586,1354,771,926,1697,208,566,774,2894,2601,5495
2020-11-05,28,27,55,57,20,77,140,79,219,296,129,425,629,269,898,770,587,1357,771,927,1698,209,566,775,2900,2604,5504
2020-11-06,28,27,55,57,20,77,140,80,220,296,129,425,632,269,901,773,588,1361,774,929,1703,209,567,776,2909,2609,5518
2020-11-07,28,27,55,57,20,77,140,80,220,296,129,425,632,271,903,773,589,1362,776,929,1705,209,567,776,2911,2612,5523
2020-11-08,28,27,55,57,20,77,140,80,220,296,129,425,633,271,904,774,589,1363,778,930,1708,210,567,777,2916,2613,5529
2020-11-09,28,28,56,57,20,77,140,80,220,296,129,425,634,272,906,780,590,1370,779,936,1715,210,568,778,2924,2623,5547
2020-11-10,28,28,56,57,20,77,140,80,220,297,129,426,637,272,909,781,597,1378,779,939,1718,210,568,778,2929,2633,5562
2020-11-11,28,28,56,57,20,77,140,80,220,299,130,429,637,273,910,782,598,1380,779,941,1720,211,569,780,2933,2639,5572
2020-11-12,28,28,56,57,20,77,140,80,220,299,130,429,639,273,912,782,598,1380,779,941,1720,211,571,782,2935,2641,5576
2020-11-13,28,28,56,57,20,77,140,80,220,300,130,430,640,273,913,785,598,1383,780,944,1724,212,572,784,2942,2645,5587
2020-11-14,28,28,56,57,20,77,140,80,220,301,130,431,641,273,914,787,598,1385,782,946,1728,212,572,784,2948,2647,5595
2020-11-15,28,28,56,57,20,77,140,80,220,301,130,431,643,273,916,788,599,1387,783,948,1731,213,572,785,2953,2650,5603
2020-11-16,28,28,56,57,20,77,140,80,220,301,130,431,645,273,918,789,601,1390,787,949,1736,213,573,786,2960,2654,5614
2020-11-17,28,28,56,57,20,77,140,80,220,303,130,433,648,273,921,791,601,1392,788,954,1742,213,573,786,2968,2659,5627
2020-11-18,28,28,56,57,20,77,140,80,220,303,130,433,649,273,922,794,601,1395,790,954,1744,213,574,787,2974,2660,5634
2020-11-19,28,28,56,57,20,77,140,81,221,303,130,433,649,273,922,797,601,1398,790,955,1745,213,575,788,2977,2663,5640
2020-11-20,28,28,56,57,20,77,140,81,221,303,130,433,650,273,923,798,602,1400,794,956,1750,213,575,788,2983,2665,5648
2020-11-21,28,28,56,57,20,77,140,81,221,303,130,433,650,273,923,799,602,1401,795,957,1752,213,575,788,2985,2666,5651
2020-11-22,28,28,56,57,20,77,140,81,221,304,130,434,652,273,925,800,604,1404,796,958,1754,213,576,789,2990,2670,5660
2020-11-23,28,28,56,57,20,77,140,81,221,304,130,434,652,273,925,802,606,1408,796,960,1756,213,577,790,2992,2675,5667
2020-11-24,28,28,56,57,20,77,140,81,221,304,130,434,654,273,927,803,606,1409,798,960,1758,213,578,791,2997,2676,5673
2020-11-25,28,28,56,57,20,77,142,81,223,304,130,434,655,274,929,804,607,1411,800,961,1761,213,579,792,3003,2680,5683
2020-11-26,29,28,57,58,20,78,142,81,223,304,130,434,656,274,930,804,607,1411,801,961,1762,214,580,794,3008,2681,5689
2020-11-27,29,28,57,58,20,78,142,81,223,305,130,435,657,274,931,805,609,1414,801,961,1762,215,582,797,3012,2685,5697
2020-11-28,29,28,57,58,20,78,143,81,224,305,130,435,658,274,932,805,610,1415,802,962,1764,215,582,797,3015,2687,5702
2020-11-29,29,28,57,58,20,78,143,81,224,305,130,435,659,274,933,806,610,1416,802,963,1765,216,582,798,3018,2688,5706
2020-11-30,29,28,57,58,20,78,143,81,224,305,130,435,659,274,933,807,611,1418,802,964,1766,216,583,799,3019,2691,5710
2020-12-01,29,28,57,58,20,78,143,81,224,306,130,436,659,275,934,807,612,1419,803,964,1767,216,583,799,3021,2693,5714
2020-12-02,29,28,57,58,20,78,143,81,224,306,130,436,661,277,938,807,614,1421,804,966,1770,216,588,804,3024,2704,5728
2020-12-03,29,28,57,58,20,78,143,81,224,307,130,437,662,277,939,808,616,1424,806,966,1772,216,588,804,3029,2706,5735
2020-12-04,29,28,57,58,20,78,143,81,224,307,130,437,664,277,941,809,617,1426,810,967,1777,216,588,804,3036,2708,5744
2020-12-05,29,28,57,58,20,78,143,81,224,307,130,437,664,277,941,809,620,1429,815,967,1782,216,588,804,3041,2711,5752
2020-12-06,29,28,57,58,20,78,143,81,224,307,130,437,665,277,942,810,622,1432,816,967,1783,216,588,804,3044,2713,5757
2020-12-07,29,28,57,58,20,78,143,81,224,308,130,438,666,278,944,812,623,1435,818,968,1786,216,588,804,3050,2716,5766
2020-12-08,29,28,57,58,20,78,143,81,224,309,130,439,668,279,947,813,627,1440,819,968,1787,217,589,806,3056,2722,5778
2020-12-09,29,28,57,58,21,79,143,81,224,309,130,439,670,280,950,813,627,1440,819,968,1787,217,589,806,3058,2724,5782
2020-12-10,29,28,57,58,21,79,143,81,224,311,130,441,672,280,952,815,631,1446,820,970,1790,217,591,808,3065,2732,5797
2020-12-11,29,28,57,58,21,79,143,81,224,311,131,442,673,280,953,815,632,1447,821,973,1794,217,592,809,3067,2738,5805
2020-12-12,29,28,57,58,21,79,143,81,224,311,132,443,673,280,953,817,632,1449,822,973,1795,217,592,809,3070,2739,5809
2020-12-13,29,28,57,58,21,79,144,81,225,311,132,443,674,281,955,819,632,1451,825,973,1798,218,592,810,3078,2740,5818
2020-12-14,29,28,57,58,21,79,144,81,225,311,132,443,677,282,959,822,633,1455,826,974,1800,218,592,810,3085,2743,5828
2020-12-15,29,28,57,58,21,79,144,81,225,311,132,443,679,282,961,824,635,1459,827,975,1802,218,592,810,3090,2746,5836
2020-12-16,29,28,57,58,21,79,144,81,225,311,132,443,680,283,963,827,637,1464,830,978,1808,219,593,812,3098,2753,5851
2020-12-17,29,28,57,58,21,79,145,81,226,311,132,443,680,283,963,830,641,1471,830,978,1808,219,594,813,3102,2758,5860
2020-12-18,29,28,57,59,21,80,145,81,226,313,132,445,680,284,964,834,642,1476,830,981,1811,219,597,816,3109,2766,5875
2020-12-19,29,28,57,59,21,80,145,81,226,314,132,446,682,284,966,836,642,1478,830,983,1813,219,598,817,3114,2769,5883
2020-12-20,29,28,57,59,21,80,145,81,226,314,132,446,685,286,971,836,642,1478,831,983,1814,221,599,820,3120,2772,5892
2020-12-21,29,28,57,60,21,81,145,81,226,316,133,449,688,286,974,840,642,1482,833,987,1820,221,600,821,3132,2778,5910
2020-12-22,29,28,57,60,21,81,145,81,226,317,133,450,690,286,976,841,643,1484,833,988,1821,221,601,822,3136,2781,5917
2020-12-23,29,28,57,60,22,82,145,81,226,320,133,453,692,286,978,845,647,1492,836,991,1827,221,601,822,3148,2789,5937
2020-12-24,29,28,57,60,22,82,145,81,226,320,133,453,693,286,979,845,647,1492,837,992,1829,221,602,823,3150,2791,5941
2020-12-25,29,28,57,60,22,82,146,82,228,322,133,455,693,287,980,847,647,1494,837,992,1829,221,603,824,3155,2794,5949
2020-12-26,29,28,57,60,23,83,146,82,228,324,133,457,693,288,981,851,649,1500,839,995,1834,221,603,824,3163,2801,5964
2020-12-27,29,28,57,61,23,84,146,82,228,324,133,457,696,288,984,856,650,1506,840,996,1836,221,603,824,3173,2803,5976
2020-12-28,29,28,57,61,23,84,147,82,229,325,133,458,698,289,987,864,651,1515,845,1001,1846,222,604,826,3191,2811,6002
2020-12-29,29,28,57,61,23,84,147,82,229,325,134,459,703,290,993,867,653,1520,850,1001,1851,223,605,828,3205,2816,6021
2020-12-30,29,28,57,61,23,84,147,82,229,327,134,461,703,291,994,871,656,1527,851,1002,1853,223,605,828,3212,2821,6033
2020-12-31,29,28,57,61,23,84,147,82,229,328,134,462,704,292,996,874,658,1532,852,1004,1856,223,605,828,3218,2826,6044
2021-01-01,29,28,57,61,23,84,147,82,229,328,134,462,706,293,999,877,660,1537,852,1004,1856,223,605,828,3223,2829,6052
2021-01-02,29,28,57,61,23,84,148,82,230,329,136,465,706,296,1002,877,660,1537,854,1005,1859,226,605,831,3230,2835,6065
2021-01-03,29,28,57,61,23,84,148,82,230,332,138,470,706,296,1002,878,661,1539,855,1007,1862,226,605,831,3235,2840,6075
2021-01-04,29,28,57,61,23,84,148,82,230,333,138,471,707,297,1004,885,661,1546,861,1015,1876,227,606,833,3251,2850,6101
2021-01-05,29,28,57,61,24,85,149,82,231,333,138,471,709,298,1007,886,661,1547,862,1017,1879,227,610,837,3256,2858,6114
2021-01-06,29,28,57,61,24,85,151,82,233,335,139,474,713,298,1011,892,663,1555,862,1020,1882,227,610,837,3270,2864,6134
2021-01-07,30,28,58,61,24,85,151,83,234,335,140,475,715,300,1015,896,665,1561,866,1022,1888,232,611,843,3286,2873,6159
2021-01-08,30,28,58,61,24,85,151,83,234,338,140,478,721,302,1023,899,668,1567,868,1025,1893,232,612,844,3300,2882,6182
2021-01-09,30,28,58,61,24,85,152,83,235,339,141,480,721,302,1023,902,671,1573,868,1028,1896,232,613,845,3305,2890,6195
2021-01-10,30,28,58,61,24,85,152,83,235,341,141,482,724,304,1028,905,671,1576,870,1029,1899,232,613,845,3315,2893,6208
2021-01-11,30,28,58,61,25,86,153,83,236,344,141,485,729,304,1033,910,672,1582,871,1032,1903,232,616,848,3330,2901,6231
2021-01-12,30,28,58,61,25,86,153,83,236,345,141,486,734,306,1040,915,673,1588,873,1036,1909,232,618,850,3343,2910,6253
2021-01-13,30,28,58,61,25,86,153,83,236,350,144,494,737,307,1044,918,674,1592,876,1038,1914,233,619,852,3358,2918,6276
2021-01-14,30,28,58,61,25,86,153,83,236,353,144,497,741,309,1050,922,677,1599,881,1038,1919,235,619,854,3376,2923,6299
2021-01-15,30,28,58,62,25,87,153,84,237,353,144,497,743,310,1053,924,680,1604,885,1040,1925,235,619,854,3385,2930,6315
2021-01-16,30,28,58,62,25,87,153,84,237,353,144,497,743,311,1054,926,682,1608,886,1042,1928,235,619,854,3388,2935,6323
2021-01-17,30,28,58,62,26,88,153,84,237,353,144,497,745,311,1056,932,682,1614,889,1043,1932,235,619,854,3399,2937,6336
2021-01-18,30,28,58,62,26,88,153,84,237,353,144,497,749,314,1063,934,684,1618,891,1048,1939,236,620,856,3408,2948,6356
2021-01-19,30,28,58,62,26,88,153,84,237,356,144,500,750,314,1064,937,686,1623,896,1052,1948,236,622,858,3420,2956,6376
2021-01-20,30,28,58,62,27,89,153,84,237,358,144,502,754,315,1069,941,687,1628,900,1055,1955,236,626,862,3434,2966,6400
2021-01-21,30,28,58,62,27,89,154,84,238,361,145,506,758,317,1075,945,689,1634,904,1061,1965,237,627,864,3451,2978,6429
2021-01-22,30,28,58,62,27,89,154,84,238,361,145,506,762,319,1081,946,690,1636,905,1064,1969,238,628,866,3458,2985,6443
2021-01-23,31,28,59,62,27,89,154,84,238,361,145,506,762,319,1081,952,696,1648,906,1066,1972,238,628,866,3466,2993,6459
2021-01-24,31,28,59,62,27,89,154,84,238,361,145,506,763,320,1083,954,698,1652,907,1066,1973,238,628,866,3470,2996,6466
2021-01-25,31,28,59,62,28,90,154,84,238,362,145,507,764,320,1084,958,700,1658,909,1070,1979,239,628,867,3479,3003,6482
2021-01-26,31,28,59,62,28,90,155,84,239,363,146,509,767,321,1088,959,703,1662,913,1073,1986,239,630,869,3489,3013,6502
2021-01-27,31,28,59,62,28,90,156,84,240,363,146,509,768,322,1090,961,705,1666,916,1077,1993,240,630,870,3497,3020,6517
2021-01-28,31,28,59,62,28,90,156,84,240,363,146,509,768,324,1092,963,706,1669,918,1078,1996,240,631,871,3501,3025,6526
2021-01-29,31,28,59,62,28,90,156,85,241,364,146,510,770,324,1094,967,706,1673,920,1082,2002,242,632,874,3512,3031,6543
2021-01-30,31,28,59,62,28,90,156,85,241,366,146,512,772,326,1098,967,708,1675,920,1083,2003,243,632,875,3517,3036,6553
2021-01-31,31,28,59,62,28,90,156,85,241,367,146,513,772,327,1099,973,709,1682,920,1084,2004,243,633,876,3524,3040,6564
2021-02-01,31,28,59,62,28,90,156,85,241,368,147,515,775,329,1104,978,713,1691,922,1086,2008,243,634,877,3535,3050,6585
2021-02-02,31,28,59,62,28,90,156,85,241,369,149,518,777,331,1108,980,716,1696,924,1091,2015,243,636,879,3542,3064,6606
2021-02-03,31,28,59,63,28,91,157,85,242,370,150,520,779,332,1111,982,717,1699,928,1092,2020,244,636,880,3554,3068,6622
2021-02-04,31,28,59,63,28,91,158,86,244,371,150,521,786,335,1121,987,720,1707,932,1095,2027,244,637,881,3572,3079,6651
2021-02-05,31,28,59,63,28,91,158,86,244,372,150,522,788,335,1123,990,722,1712,934,1097,2031,244,638,882,3580,3084,6664
2021-02-06,31,28,59,63,28,91,158,88,246,372,150,522,790,337,1127,994,723,1717,936,1097,2033,244,639,883,3588,3090,6678
2021-02-07,31,28,59,63,28,91,158,88,246,372,151,523,791,339,1130,999,724,1723,940,1099,2039,244,640,884,3598,3097,6695
2021-02-08,31,28,59,63,28,91,158,88,246,376,151,527,794,339,1133,1004,733,1737,942,1104,2046,244,640,884,3612,3111,6723
2021-02-09,31,28,59,63,28,91,159,88,247,376,151,527,794,341,1135,1005,736,1741,945,1105,2050,244,640,884,3617,3117,6734
2021-02-10,31,28,59,64,28,92,159,88,247,377,152,529,795,342,1137,1007,738,1745,945,1109,2054,245,640,885,3623,3125,6748
2021-02-11,31,28,59,64,28,92,159,88,247,377,152,529,797,343,1140,1010,739,1749,946,1109,2055,246,641,887,3630,3128,6758
2021-02-12,31,28,59,64,28,92,160,88,248,378,153,531,798,345,1143,1013,744,1757,949,1113,2062,247,641,888,3640,3140,6780
2021-02-13,31,28,59,64,28,92,160,89,249,378,153,531,799,345,1144,1017,747,1764,950,1116,2066,247,642,889,3646,3148,6794
2021-02-14,31,28,59,64,28,92,160,89,249,378,153,531,800,346,1146,1020,750,1770,950,1117,2067,247,642,889,3650,3153,6803
2021-02-15,31,28,59,65,28,93,161,89,250,378,153,531,802,346,1148,1021,750,1771,952,1118,2070,247,643,890,3657,3155,6812
2021-02-16,31,28,59,65,28,93,161,89,250,378,153,531,802,347,1149,1024,750,1774,954,1121,2075,247,647,894,3662,3163,6825
2021-02-17,31,28,59,65,28,93,161,89,250,378,153,531,802,347,1149,1026,750,1776,957,1123,2080,247,647,894,3667,3165,6832
2021-02-18,31,28,59,66,28,94,161,89,250,379,154,533,806,348,1154,1028,751,1779,957,1125,2082,247,647,894,3675,3170,6845
2021-02-19,31,28,59,66,28,94,161,89,250,381,156,537,807,349,1156,1030,751,1781,957,1125,2082,247,647,894,3680,3173,6853
2021-02-20,31,28,59,66,28,94,161,89,250,381,156,537,808,349,1157,1031,753,1784,958,1126,2084,248,648,896,3684,3177,6861
2021-02-21,31,28,59,66,29,95,161,89,250,381,156,537,810,349,1159,1032,754,1786,960,1127,2087,248,649,897,3689,3181,6870
2021-02-22,31,28,59,66,29,95,161,89,250,382,156,538,812,350,1162,1034,756,1790,961,1129,2090,250,649,899,3697,3186,6883
2021-02-23,31,28,59,66,29,95,161,89,250,383,156,539,813,350,1163,1035,758,1793,964,1131,2095,251,649,900,3704,3190,6894
2021-02-24,31,28,59,66,30,96,161,89,250,384,156,540,814,351,1165,1037,759,1796,966,1131,2097,251,652,903,3710,3196,6906
2021-02-25,31,28,59,66,30,96,161,89,250,385,156,541,816,351,1167,1039,761,1800,967,1132,2099,252,652,904,3717,3199,6916
2021-02-26,31,28,59,66,30,96,161,89,250,386,156,542,816,352,1168,1043,761,1804,968,1137,2105,254,653,907,3725,3206,6931
2021-02-27,31,28,59,66,30,96,161,89,250,388,156,544,816,352,1168,1044,763,1807,973,1140,2113,254,654,908,3733,3212,6945
2021-02-28,31,28,59,66,30,96,161,89,250,389,156,545,816,352,1168,1044,763,1807,973,1141,2114,254,654,908,3734,3213,6947
2021-03-01,31,28,59,66,30,96,161,89,250,390,156,546,817,352,1169,1046,767,1813,974,1145,2119,254,654,908,3739,3221,6960
2021-03-02,31,28,59,67,30,97,161,89,250,390,156,546,818,353,1171,1049,768,1817,976,1145,2121,254,654,908,3746,3223,6969
2021-03-03,31,28,59,67,30,97,161,89,250,390,156,546,818,354,1172,1050,769,1819,979,1145,2124,254,654,908,3750,3225,6975
2021-03-04,31,28,59,67,30,97,161,89,250,391,156,547,819,355,1174,1053,770,1823,981,1145,2126,254,654,908,3757,3227,6984
2021-03-05,31,28,59,67,30,97,162,89,251,392,156,548,820,355,1175,1055,771,1826,981,1147,2128,254,654,908,3762,3230,6992
2021-03-06,31,29,60,67,30,97,162,89,251,392,156,548,820,355,1175,1056,771,1827,982,1147,2129,254,655,909,3764,3232,6996
2021-03-07,31,29,60,67,30,97,162,89,251,392,156,548,821,357,1178,1057,771,1828,983,1147,2130,254,656,910,3767,3235,7002
2021-03-08,31,29,60,67,30,97,162,89,251,392,158,550,822,357,1179,1059,771,1830,985,1148,2133,255,656,911,3773,3238,7011
2021-03-09,31,29,60,67,30,97,162,89,251,394,158,552,824,358,1182,1061,771,1832,989,1151,2140,255,656,911,3783,3242,7025
2021-03-10,31,29,60,68,30,98,162,89,251,394,158,552,825,362,1187,1064,775,1839,989,1153,2142,255,657,912,3788,3253,7041
2021-03-11,31,29,60,68,30,98,162,89,251,395,158,553,827,363,1190,1067,775,1842,991,1154,2145,255,658,913,3796,3256,7052
2021-03-12,31,29,60,68,30,98,162,89,251,396,158,554,829,363,1192,1072,777,1849,992,1157,2149,255,663,918,3805,3266,7071
2021-03-13,31,29,60,68,30,98,162,89,251,396,158,554,830,363,1193,1075,778,1853,994,1157,2151,255,663,918,3811,3267,7078
2021-03-14,31,29,60,68,30,98,162,89,251,396,158,554,831,363,1194,1076,779,1855,997,1158,2155,255,663,918,3816,3269,7085
2021-03-15,31,29,60,68,30,98,162,89,251,397,158,555,832,365,1197,1078,779,1857,997,1161,2158,255,664,919,3820,3275,7095
2021-03-16,31,29,60,68,30,98,162,89,251,397,158,555,833,366,1199,1080,779,1859,998,1165,2163,256,664,920,3825,3280,7105
2021-03-17,31,29,60,68,30,98,162,89,251,397,158,555,835,366,1201,1082,780,1862,999,1166,2165,256,666,922,3830,3284,7114
2021-03-18,31,29,60,68,30,98,163,89,252,398,158,556,835,366,1201,1083,784,1867,1000,1166,2166,256,667,923,3834,3289,7123
2021-03-19,31,29,60,68,30,98,163,89,252,399,159,558,836,367,1203,1083,787,1870,1001,1167,2168,256,667,923,3837,3295,7132
2021-03-20,31,29,60,68,30,98,163,90,253,399,159,558,837,367,1204,1085,787,1872,1001,1168,2169,256,667,923,3840,3297,7137
2021-03-21,31,29,60,68,30,98,163,90,253,401,159,560,838,367,1205,1086,787,1873,1002,1169,2171,256,667,923,3845,3298,7143
2021-03-22,31,29,60,68,30,98,163,90,253,401,159,560,839,367,1206,1086,787,1873,1004,1172,2176,257,668,925,3849,3302,7151
2021-03-23,31,29,60,68,30,98,163,90,253,401,160,561,841,367,1208,1088,788,1876,1005,1172,2177,257,668,925,3854,3304,7158
2021-03-24,31,29,60,68,30,98,163,90,253,401,160,561,842,367,1209,1088,788,1876,1007,1172,2179,257,669,926,3857,3305,7162
2021-03-25,31,29,60,68,30,98,163,90,253,401,160,561,842,369,1211,1089,789,1878,1007,1176,2183,257,669,926,3858,3312,7170
2021-03-26,31,29,60,68,30,98,163,90,253,401,160,561,843,369,1212,1091,791,1882,1008,1176,2184,257,669,926,3862,3314,7176
2021-03-27,31,29,60,68,30,98,163,90,253,401,160,561,843,370,1213,1092,792,1884,1009,1177,2186,258,669,927,3865,3317,7182
2021-03-28,31,29,60,68,30,98,163,90,253,402,160,562,843,370,1213,1092,792,1884,1009,1177,2186,258,669,927,3866,3317,7183
2021-03-29,31,29,60,68,30,98,163,90,253,402,160,562,843,370,1213,1093,792,1885,1009,1179,2188,258,669,927,3867,3319,7186
2021-03-30,31,29,60,68,30,98,163,90,253,402,160,562,843,370,1213,1094,792,1886,1009,1179,2188,258,669,927,3868,3319,7187
2021-03-31,31,29,60,68,30,98,163,90,253,402,160,562,843,370,1213,1096,793,1889,1009,1179,2188,258,669,927,3870,3320,7190
2021-04-01,31,29,60,68,30,98,163,90,253,402,160,562,843,370,1213,1096,793,1889,1009,1179,2188,258,669,927,3870,3320,7190
2021-04-02,31,29,60,68,30,98,163,90,253,402,160,562,844,370,1214,1096,793,1889,1010,1180,2190,258,669,927,3872,3321,7193
2021-04-03,31,29,60,68,30,98,163,90,253,402,160,562,845,370,1215,1096,793,1889,1010,1180,2190,258,669,927,3873,3321,7194
2021-04-04,31,29,60,68,30,98,163,90,253,402,160,562,845,370,1215,1096,793,1889,1010,1180,2190,259,669,928,3874,3321,7195
2021-04-05,31,29,60,68,30,98,163,90,253,402,160,562,845,370,1215,1096,794,1890,1010,1180,2190,259,669,928,3874,3322,7196
2021-04-06,31,29,60,68,30,98,163,90,253,402,160,562,845,370,1215,1097,794,1891,1010,1180,2190,259,669,928,3875,3322,7197
2021-04-07,31,29,60,68,30,98,163,90,253,402,160,562,845,370,1215,1097,794,1891,1010,1180,2190,259,669,928,3875,3322,7197
2021-04-08,31,29,60,68,30,98,163,90,253,402,160,562,845,370,1215,1097,794,1891,1010,1180,2190,259,669,928,3875,3322,7197
