FECHA,<=10M,<=10F,<=10,11-20M,11-20F,11-20,21-30M,21-30F,21-30,31-40M,31-40F,31-40,41-50M,41-50F,41-50,51-60M,51-60F,51-60,61-70M,61-70F,61-70,71-80M,71-80F,71-80,81-90M,81-90F,81-90,>=91M,>=91F,>=91,TotalM,TotalF,Total
2020-03-15,0,0,0,0,0,0,0,0,0,0,0,0,0,0,0,0,0,0,0,0,0,0,0,0,0,0,0,0,0,0,0,0,0
2020-03-16,0,0,0,0,0,0,0,0,0,0,0,0,0,0,0,0,0,0,0,0,0,0,0,0,0,0,0,0,0,0,0,0,0
2020-03-17,0,0,0,0,0,0,0,0,0,0,0,0,0,0,0,0,0,0,0,0,0,1,0,1,0,0,0,0,0,0,1,0,1
2020-03-18,0,0,0,0,0,0,0,0,0,0,0,0,0,0,0,0,0,0,0,0,0,1,0,1,0,0,0,0,0,0,1,0,1
2020-03-19,0,0,0,0,0,0,0,0,0,0,0,0,0,0,0,0,0,0,0,0,0,1,0,1,0,0,0,0,0,0,1,0,1
2020-03-20,0,0,0,0,0,0,0,0,0,0,0,0,0,0,0,0,0,0,0,0,0,1,0,1,0,1,1,0,0,0,1,1,2
2020-03-21,0,0,0,0,0,0,0,0,0,0,0,0,0,0,0,0,0,0,1,0,1,3,0,3,0,1,1,0,0,0,4,1,5
2020-03-22,0,0,0,0,0,0,0,0,0,0,0,0,0,0,0,0,0,0,1,0,1,4,0,4,0,1,1,0,0,0,5,1,6
2020-03-23,0,0,0,0,0,0,0,0,0,0,0,0,0,0,0,0,0,0,1,0,1,4,0,4,0,1,1,0,0,0,5,1,6
2020-03-24,0,0,0,0,0,0,0,0,0,0,0,0,0,0,0,0,0,0,1,0,1,4,1,5,0,1,1,0,0,0,5,2,7
2020-03-25,0,0,0,0,0,0,0,0,0,0,0,0,0,0,0,0,0,0,2,0,2,4,1,5,1,3,4,0,1,1,7,5,12
2020-03-26,0,0,0,0,0,0,0,0,0,0,0,0,0,0,0,1,0,1,3,0,3,5,1,6,1,3,4,0,1,1,10,5,15
2020-03-27,0,0,0,0,0,0,0,0,0,0,0,0,0,0,0,2,0,2,4,0,4,5,1,6,1,3,4,0,1,1,12,5,17
2020-03-28,0,0,0,0,0,0,0,0,0,0,0,0,0,0,0,2,0,2,4,0,4,5,1,6,3,3,6,0,1,1,14,5,19
2020-03-29,0,0,0,0,0,0,0,0,0,0,0,0,0,0,0,2,0,2,4,0,4,5,1,6,3,3,6,0,1,1,14,5,19
2020-03-30,0,0,0,0,0,0,0,0,0,0,0,0,1,0,1,2,0,2,5,0,5,7,1,8,3,3,6,0,2,2,18,6,24
2020-03-31,0,0,0,0,0,0,0,0,0,0,0,0,1,0,1,2,0,2,6,0,6,9,2,11,3,4,7,0,2,2,21,8,29
2020-04-01,0,0,0,0,0,0,0,0,0,0,0,0,1,0,1,2,0,2,8,0,8,9,2,11,3,4,7,0,2,2,23,8,31
2020-04-02,0,0,0,0,0,0,0,0,0,0,0,0,1,0,1,2,0,2,8,0,8,11,2,13,3,4,7,1,3,4,26,9,35
2020-04-03,0,0,0,0,0,0,0,0,0,0,0,0,1,0,1,2,1,3,8,1,9,12,2,14,3,5,8,1,3,4,27,12,39
2020-04-04,0,0,0,0,0,0,0,0,0,0,0,0,1,0,1,2,1,3,8,1,9,12,2,14,3,5,8,2,3,5,28,12,40
2020-04-05,0,0,0,0,0,0,0,0,0,0,0,0,1,1,2,2,1,3,8,1,9,14,2,16,3,5,8,2,3,5,30,13,43
2020-04-06,0,0,0,0,0,0,0,0,0,0,0,0,1,1,2,2,1,3,9,1,10,14,3,17,3,5,8,2,3,5,31,14,45
2020-04-07,0,0,0,0,0,0,0,0,0,0,0,0,1,1,2,2,1,3,9,1,10,14,5,19,3,5,8,3,3,6,32,16,48
2020-04-08,0,0,0,0,0,0,0,0,0,0,0,0,1,1,2,3,1,4,9,1,10,15,5,20,3,6,9,3,3,6,34,17,51
2020-04-09,0,0,0,0,0,0,0,0,0,0,0,0,1,1,2,3,1,4,9,1,10,15,5,20,3,6,9,3,3,6,34,17,51
2020-04-10,0,0,0,0,0,0,0,0,0,0,0,0,1,1,2,3,1,4,9,1,10,15,5,20,3,6,9,3,3,6,34,17,51
2020-04-11,0,0,0,0,0,0,0,0,0,0,0,0,1,1,2,3,1,4,9,1,10,15,5,20,5,6,11,3,3,6,36,17,53
2020-04-12,0,0,0,0,0,0,0,0,0,0,0,0,1,1,2,3,1,4,9,1,10,15,5,20,5,6,11,3,3,6,36,17,53
2020-04-13,0,0,0,0,0,0,0,0,0,0,0,0,1,1,2,3,1,4,9,1,10,15,5,20,5,6,11,3,3,6,36,17,53
2020-04-14,0,0,0,0,0,0,0,0,0,0,0,0,1,1,2,3,1,4,9,1,10,18,5,23,5,7,12,3,3,6,39,18,57
2020-04-15,0,0,0,0,0,0,0,0,0,0,0,0,1,1,2,3,1,4,9,1,10,18,5,23,5,7,12,3,3,6,39,18,57
2020-04-16,0,0,0,0,0,0,0,0,0,0,0,0,1,1,2,3,1,4,9,1,10,18,5,23,5,7,12,3,3,6,39,18,57
2020-04-17,0,0,0,0,0,0,1,0,1,0,0,0,1,1,2,3,1,4,9,1,10,18,6,24,7,9,16,3,5,8,42,23,65
2020-04-18,0,0,0,0,0,0,1,0,1,0,0,0,2,1,3,3,1,4,9,1,10,18,7,25,8,11,19,3,7,10,44,28,72
2020-04-19,0,0,0,0,0,0,1,0,1,0,0,0,2,1,3,3,1,4,9,1,10,18,7,25,8,11,19,4,7,11,45,28,73
2020-04-20,0,0,0,0,0,0,1,0,1,0,0,0,3,1,4,3,1,4,9,1,10,18,7,25,9,11,20,4,8,12,47,29,76
2020-04-21,0,0,0,0,0,0,1,0,1,0,0,0,3,1,4,4,1,5,10,1,11,18,7,25,11,11,22,5,11,16,52,32,84
2020-04-22,0,0,0,0,0,0,1,0,1,1,0,1,3,1,4,4,1,5,11,1,12,19,10,29,12,13,25,6,14,20,57,40,97
2020-04-23,0,0,0,0,0,0,1,0,1,1,0,1,3,1,4,4,1,5,12,2,14,21,12,33,15,13,28,6,17,23,63,46,109
2020-04-24,0,0,0,0,0,0,1,0,1,1,0,1,3,1,4,4,1,5,12,2,14,21,12,33,17,15,32,6,17,23,65,48,113
2020-04-25,0,0,0,0,0,0,1,0,1,1,0,1,3,1,4,5,1,6,12,2,14,21,12,33,17,17,34,6,17,23,66,50,116
2020-04-26,0,0,0,0,0,0,1,0,1,1,0,1,3,1,4,5,1,6,12,2,14,21,12,33,17,17,34,6,17,23,66,50,116
2020-04-27,0,0,0,0,0,0,1,0,1,1,0,1,3,1,4,5,1,6,13,2,15,22,13,35,18,18,36,7,18,25,70,53,123
2020-04-28,0,0,0,0,0,0,1,0,1,1,0,1,3,1,4,5,1,6,13,2,15,22,13,35,19,20,39,7,18,25,71,55,126
2020-04-29,0,0,0,0,0,0,1,0,1,1,0,1,3,1,4,5,1,6,13,2,15,23,13,36,19,20,39,7,18,25,72,55,127
2020-04-30,0,0,0,0,0,0,1,0,1,1,0,1,3,1,4,6,1,7,13,2,15,23,13,36,19,20,39,7,18,25,73,55,128
2020-05-01,0,0,0,0,0,0,1,0,1,1,0,1,3,1,4,6,1,7,14,2,16,23,13,36,19,21,40,8,18,26,75,56,131
2020-05-02,0,0,0,0,0,0,1,0,1,1,0,1,3,1,4,6,1,7,14,2,16,24,13,37,19,21,40,8,18,26,76,56,132
2020-05-03,0,0,0,0,0,0,1,0,1,1,0,1,3,1,4,7,1,8,15,2,17,24,13,37,20,21,41,8,18,26,79,56,135
2020-05-04,0,0,0,0,0,0,1,0,1,1,0,1,3,1,4,8,1,9,15,2,17,24,13,37,20,23,43,8,18,26,80,58,138
2020-05-05,0,0,0,0,0,0,1,0,1,2,0,2,3,2,5,8,1,9,15,2,17,25,13,38,23,23,46,8,20,28,85,61,146
2020-05-06,0,0,0,0,0,0,1,0,1,2,0,2,4,2,6,8,1,9,16,3,19,26,13,39,23,23,46,10,22,32,90,64,154
2020-05-07,0,0,0,0,0,0,1,0,1,2,0,2,4,2,6,10,1,11,16,3,19,26,14,40,24,23,47,10,24,34,93,67,160
2020-05-08,0,0,0,0,0,0,1,0,1,2,0,2,4,2,6,10,1,11,16,3,19,26,14,40,24,24,48,10,24,34,93,68,161
2020-05-09,0,0,0,0,0,0,1,0,1,2,0,2,4,2,6,10,1,11,16,4,20,26,14,40,24,24,48,11,24,35,94,69,163
2020-05-10,0,0,0,0,0,0,1,0,1,2,0,2,4,2,6,10,1,11,17,4,21,26,14,40,24,24,48,11,24,35,95,69,164
2020-05-11,0,0,0,0,0,0,1,0,1,2,0,2,5,3,8,10,1,11,18,4,22,26,14,40,24,24,48,11,24,35,97,70,167
2020-05-12,0,0,0,0,0,0,1,0,1,3,0,3,5,3,8,12,2,14,19,5,24,28,17,45,24,25,49,12,25,37,104,77,181
2020-05-13,0,0,0,0,0,0,1,0,1,3,0,3,6,3,9,12,3,15,21,5,26,28,17,45,24,25,49,12,28,40,107,81,188
2020-05-14,0,0,0,0,0,0,1,0,1,3,0,3,6,3,9,14,3,17,22,5,27,29,18,47,24,26,50,12,28,40,111,83,194
2020-05-15,0,0,0,0,0,0,1,0,1,3,0,3,6,4,10,14,3,17,22,5,27,29,19,48,24,27,51,13,29,42,112,87,199
2020-05-16,0,0,0,0,0,0,1,0,1,4,0,4,6,5,11,14,3,17,23,6,29,31,20,51,24,28,52,13,32,45,116,94,210
2020-05-17,0,1,1,0,0,0,1,0,1,4,0,4,6,6,12,17,3,20,24,6,30,32,20,52,26,31,57,13,32,45,123,99,222
2020-05-18,0,1,1,0,0,0,1,0,1,5,0,5,6,6,12,20,3,23,26,7,33,34,21,55,26,31,57,13,32,45,131,101,232
2020-05-19,0,1,1,0,0,0,1,0,1,5,0,5,7,6,13,21,3,24,26,7,33,34,21,55,26,33,59,14,32,46,134,103,237
2020-05-20,0,1,1,0,0,0,1,1,2,6,0,6,7,7,14,24,4,28,27,7,34,35,22,57,27,35,62,15,32,47,142,109,251
2020-05-21,0,1,1,0,0,0,1,1,2,6,0,6,8,7,15,24,4,28,29,7,36,35,23,58,27,36,63,15,35,50,145,114,259
2020-05-22,0,1,1,0,0,0,1,1,2,6,0,6,8,7,15,27,4,31,30,9,39,35,23,58,27,36,63,15,35,50,149,116,265
2020-05-23,0,1,1,0,0,0,1,1,2,6,0,6,11,7,18,29,4,33,30,9,39,36,23,59,29,40,69,15,36,51,157,121,278
2020-05-24,0,1,1,0,0,0,1,1,2,7,0,7,11,7,18,29,5,34,31,9,40,36,24,60,29,40,69,16,36,52,160,123,283
2020-05-25,0,1,1,0,0,0,1,1,2,7,0,7,11,8,19,30,5,35,32,11,43,37,28,65,30,41,71,17,36,53,165,131,296
2020-05-26,0,1,1,0,0,0,1,1,2,7,0,7,11,9,20,33,7,40,35,12,47,38,29,67,30,44,74,19,36,55,174,139,313
2020-05-27,0,1,1,0,0,0,1,1,2,7,0,7,13,10,23,33,7,40,36,12,48,40,33,73,31,46,77,19,37,56,180,147,327
2020-05-28,0,1,1,0,0,0,1,1,2,8,0,8,14,11,25,35,8,43,37,13,50,41,39,80,35,50,85,22,46,68,193,169,362
2020-05-29,0,1,1,0,0,0,1,1,2,8,0,8,15,12,27,36,8,44,38,13,51,44,41,85,37,56,93,22,49,71,201,181,382
2020-05-30,0,1,1,0,0,0,1,1,2,8,0,8,16,12,28,39,8,47,38,13,51,46,42,88,38,56,94,23,49,72,209,182,391
2020-05-31,0,1,1,0,0,0,1,1,2,8,0,8,17,12,29,40,10,50,38,13,51,50,43,93,41,58,99,24,49,73,219,187,406
2020-06-01,0,1,1,0,0,0,1,1,2,9,0,9,17,13,30,41,10,51,39,13,52,51,45,96,43,60,103,25,49,74,226,192,418
2020-06-02,1,1,2,0,0,0,1,1,2,9,0,9,18,15,33,42,11,53,45,13,58,53,47,100,44,62,106,27,52,79,240,202,442
2020-06-03,1,1,2,0,0,0,1,1,2,9,0,9,19,16,35,45,12,57,50,14,64,56,48,104,45,63,108,27,52,79,253,207,460
2020-06-04,1,1,2,0,0,0,1,1,2,10,0,10,19,16,35,46,13,59,53,15,68,59,50,109,45,66,111,30,56,86,264,218,482
2020-06-05,1,1,2,0,0,0,1,2,3,10,0,10,19,16,35,47,14,61,57,17,74,64,55,119,47,69,116,30,58,88,276,232,508
2020-06-06,1,1,2,0,0,0,1,2,3,10,0,10,19,16,35,50,14,64,57,17,74,66,57,123,49,75,124,30,61,91,283,243,526
2020-06-07,1,1,2,0,0,0,1,2,3,10,0,10,19,16,35,52,14,66,58,17,75,66,59,125,52,79,131,30,64,94,289,252,541
2020-06-08,1,1,2,0,0,0,1,2,3,12,0,12,21,16,37,53,14,67,58,18,76,71,61,132,57,80,137,30,67,97,304,259,563
2020-06-09,1,1,2,0,0,0,1,2,3,12,1,13,22,17,39,55,14,69,58,21,79,73,61,134,59,82,141,30,70,100,311,269,580
2020-06-10,1,1,2,0,0,0,1,2,3,12,1,13,22,18,40,57,15,72,60,22,82,77,62,139,60,90,150,31,73,104,321,284,605
2020-06-11,1,1,2,0,0,0,1,2,3,12,1,13,24,18,42,61,15,76,63,23,86,79,66,145,61,93,154,31,76,107,333,295,628
2020-06-12,1,1,2,0,0,0,1,2,3,13,1,14,24,18,42,65,16,81,65,25,90,86,67,153,64,93,157,32,78,110,351,301,652
2020-06-13,1,1,2,0,0,0,1,3,4,13,2,15,24,20,44,67,17,84,68,25,93,88,71,159,66,97,163,32,83,115,360,319,679
2020-06-14,1,1,2,0,0,0,1,3,4,13,2,15,25,20,45,67,18,85,71,25,96,90,72,162,67,99,166,33,87,120,368,327,695
2020-06-15,1,1,2,0,0,0,1,3,4,13,2,15,25,21,46,67,18,85,74,26,100,90,76,166,67,100,167,36,87,123,374,334,708
2020-06-16,1,1,2,0,0,0,2,3,5,14,2,16,26,21,47,70,18,88,77,29,106,98,78,176,68,102,170,36,90,126,392,344,736
2020-06-17,2,1,3,0,0,0,3,3,6,14,2,16,27,21,48,70,21,91,82,30,112,104,81,185,71,105,176,37,94,131,410,358,768
2020-06-18,2,1,3,0,0,0,3,3,6,16,2,18,29,22,51,74,22,96,84,31,115,105,83,188,76,106,182,38,95,133,427,365,792
2020-06-19,2,1,3,0,0,0,3,3,6,17,2,19,29,22,51,76,24,100,87,35,122,110,87,197,83,106,189,38,104,142,445,384,829
2020-06-20,2,1,3,0,0,0,3,3,6,18,2,20,29,22,51,77,25,102,88,37,125,117,91,208,86,111,197,40,107,147,460,399,859
2020-06-21,2,1,3,0,0,0,3,3,6,18,3,21,30,23,53,78,25,103,92,37,129,119,94,213,88,115,203,40,112,152,470,413,883
2020-06-22,2,1,3,0,0,0,3,4,7,19,3,22,32,23,55,78,26,104,97,41,138,125,98,223,94,121,215,43,113,156,493,430,923
2020-06-23,2,1,3,0,0,0,3,4,7,19,3,22,34,23,57,82,27,109,98,43,141,131,99,230,102,127,229,46,118,164,517,445,962
2020-06-24,2,1,3,0,0,0,3,4,7,19,3,22,34,25,59,84,28,112,100,45,145,135,100,235,109,131,240,47,124,171,533,461,994
2020-06-25,2,1,3,0,0,0,3,4,7,19,3,22,36,26,62,87,28,115,106,48,154,138,104,242,114,139,253,48,128,176,553,481,1034
2020-06-26,2,1,3,0,0,0,3,4,7,19,3,22,36,28,64,90,29,119,109,49,158,144,105,249,116,143,259,49,131,180,568,493,1061
2020-06-27,2,1,3,0,0,0,3,4,7,19,3,22,37,28,65,91,30,121,113,51,164,145,107,252,119,146,265,51,134,185,580,504,1084
2020-06-28,2,1,3,0,0,0,3,4,7,19,3,22,37,28,65,91,30,121,113,52,165,147,109,256,124,151,275,52,140,192,588,518,1106
2020-06-29,2,1,3,0,0,0,3,5,8,19,3,22,37,28,65,93,30,123,116,54,170,151,114,265,134,158,292,53,143,196,608,536,1144
2020-06-30,2,1,3,0,0,0,3,5,8,19,3,22,38,29,67,97,33,130,124,57,181,159,118,277,139,167,306,55,151,206,636,564,1200
2020-07-01,2,1,3,0,0,0,3,5,8,19,3,22,39,30,69,99,34,133,127,57,184,162,120,282,150,171,321,58,154,212,659,575,1234
2020-07-02,2,1,3,0,0,0,3,5,8,19,4,23,40,30,70,102,34,136,133,58,191,168,125,293,154,174,328,58,157,215,679,588,1267
2020-07-03,2,1,3,0,0,0,3,5,8,19,5,24,40,31,71,104,34,138,138,58,196,173,132,305,155,184,339,60,161,221,694,611,1305
2020-07-04,2,1,3,0,1,1,3,5,8,19,6,25,41,32,73,105,35,140,139,60,199,178,139,317,159,194,353,61,170,231,707,643,1350
2020-07-05,2,2,4,0,1,1,3,5,8,20,7,27,41,32,73,108,36,144,143,66,209,180,142,322,163,204,367,64,174,238,724,669,1393
2020-07-06,2,2,4,0,1,1,3,5,8,20,7,27,43,32,75,110,37,147,150,69,219,189,149,338,173,219,392,68,184,252,758,705,1463
2020-07-07,2,2,4,0,1,1,3,5,8,21,7,28,43,32,75,112,37,149,160,70,230,199,156,355,182,224,406,72,192,264,794,726,1520
2020-07-08,2,2,4,0,1,1,3,5,8,21,7,28,44,33,77,114,39,153,166,72,238,206,164,370,187,228,415,76,200,276,819,751,1570
2020-07-09,2,2,4,0,1,1,3,6,9,21,7,28,45,34,79,114,40,154,169,73,242,214,168,382,191,237,428,79,204,283,838,772,1610
2020-07-10,2,2,4,0,1,1,3,7,10,22,7,29,45,34,79,116,43,159,175,75,250,220,176,396,203,247,450,80,209,289,866,801,1667
2020-07-11,2,2,4,0,1,1,3,8,11,24,7,31,45,34,79,117,43,160,179,75,254,225,177,402,204,255,459,82,216,298,881,818,1699
2020-07-12,2,2,4,0,1,1,4,8,12,24,8,32,49,34,83,119,43,162,183,75,258,229,181,410,215,261,476,84,223,307,909,836,1745
2020-07-13,2,2,4,0,1,1,4,8,12,24,8,32,49,35,84,119,44,163,190,77,267,236,190,426,222,267,489,87,235,322,933,867,1800
2020-07-14,2,2,4,0,1,1,4,8,12,24,8,32,50,35,85,122,48,170,197,79,276,251,193,444,226,276,502,92,245,337,968,895,1863
2020-07-15,2,3,5,0,1,1,4,8,12,24,9,33,53,35,88,122,48,170,206,80,286,261,198,459,234,287,521,94,251,345,1000,920,1920
2020-07-16,2,3,5,0,1,1,4,8,12,25,9,34,53,35,88,123,48,171,213,82,295,269,202,471,245,297,542,100,259,359,1034,944,1978
2020-07-17,2,3,5,0,1,1,5,8,13,25,10,35,56,35,91,126,49,175,222,84,306,275,207,482,259,308,567,102,272,374,1072,977,2049
2020-07-18,2,3,5,0,1,1,6,9,15,25,10,35,58,36,94,126,50,176,226,84,310,281,213,494,263,316,579,104,278,382,1091,1000,2091
2020-07-19,2,3,5,0,1,1,6,9,15,25,10,35,58,36,94,128,51,179,226,84,310,287,215,502,271,328,599,110,282,392,1113,1019,2132
2020-07-20,2,3,5,0,1,1,6,9,15,26,11,37,60,37,97,130,53,183,232,86,318,295,223,518,280,336,616,112,284,396,1143,1043,2186
2020-07-21,2,3,5,0,1,1,8,9,17,27,11,38,62,37,99,131,54,185,246,89,335,300,228,528,290,349,639,114,294,408,1180,1075,2255
2020-07-22,2,3,5,0,1,1,8,9,17,27,11,38,62,37,99,134,54,188,252,89,341,307,235,542,299,357,656,117,302,419,1208,1098,2306
2020-07-23,2,3,5,0,1,1,8,9,17,27,12,39,63,37,100,137,55,192,258,91,349,311,242,553,306,367,673,117,306,423,1229,1123,2352
2020-07-24,2,3,5,0,1,1,8,9,17,27,12,39,65,37,102,141,56,197,263,94,357,318,245,563,314,383,697,118,310,428,1256,1150,2406
2020-07-25,2,4,6,0,1,1,8,9,17,27,12,39,65,37,102,143,59,202,267,94,361,320,248,568,321,391,712,123,321,444,1276,1176,2452
2020-07-26,2,4,6,0,1,1,9,9,18,28,12,40,67,37,104,143,60,203,269,94,363,326,254,580,331,396,727,125,327,452,1300,1194,2494
2020-07-27,2,4,6,0,1,1,9,9,18,28,13,41,68,38,106,148,63,211,270,96,366,330,260,590,343,401,744,127,332,459,1325,1217,2542
2020-07-28,2,4,6,0,1,1,9,10,19,28,13,41,69,39,108,150,64,214,275,100,375,339,267,606,352,412,764,129,338,467,1353,1248,2601
2020-07-29,2,4,6,0,1,1,9,10,19,29,14,43,70,40,110,152,65,217,280,100,380,343,271,614,357,418,775,133,339,472,1375,1262,2637
2020-07-30,2,4,6,0,1,1,9,10,19,29,14,43,74,43,117,152,65,217,282,101,383,348,275,623,361,427,788,135,344,479,1392,1284,2676
2020-07-31,2,4,6,0,1,1,9,11,20,29,14,43,76,44,120,154,67,221,286,103,389,353,280,633,365,435,800,136,355,491,1410,1314,2724
2020-08-01,2,4,6,0,1,1,9,11,20,29,14,43,78,45,123,156,68,224,289,105,394,357,284,641,369,439,808,139,362,501,1428,1333,2761
2020-08-02,2,4,6,0,1,1,9,11,20,30,14,44,79,45,124,158,69,227,291,107,398,365,290,655,374,451,825,140,367,507,1448,1359,2807
2020-08-03,2,4,6,0,1,1,10,11,21,30,14,44,80,46,126,160,70,230,300,110,410,375,298,673,379,463,842,141,381,522,1477,1398,2875
2020-08-04,2,5,7,0,1,1,10,11,21,30,14,44,81,47,128,163,73,236,307,113,420,382,301,683,389,474,863,144,393,537,1508,1432,2940
2020-08-05,2,6,8,0,1,1,10,11,21,30,14,44,82,48,130,165,76,241,317,116,433,389,305,694,399,490,889,147,401,548,1541,1468,3009
2020-08-06,2,6,8,0,1,1,10,11,21,31,14,45,85,48,133,168,77,245,321,118,439,393,311,704,406,498,904,151,410,561,1567,1494,3061
2020-08-07,2,6,8,0,1,1,10,11,21,32,14,46,86,50,136,169,77,246,322,120,442,396,316,712,413,504,917,156,412,568,1586,1511,3097
2020-08-08,2,6,8,0,1,1,10,11,21,33,14,47,86,51,137,170,79,249,327,122,449,401,320,721,419,511,930,158,416,574,1606,1531,3137
2020-08-09,2,6,8,0,1,1,10,11,21,33,14,47,86,52,138,172,80,252,336,127,463,406,323,729,425,517,942,161,416,577,1631,1547,3178
2020-08-10,2,6,8,0,1,1,10,11,21,34,14,48,87,52,139,173,85,258,341,130,471,411,326,737,431,527,958,161,421,582,1650,1573,3223
2020-08-11,2,6,8,0,1,1,10,11,21,35,14,49,88,52,140,174,85,259,346,134,480,416,330,746,435,534,969,163,425,588,1669,1592,3261
2020-08-12,3,6,9,0,1,1,10,11,21,35,14,49,89,52,141,175,86,261,347,138,485,420,334,754,439,539,978,165,428,593,1683,1609,3292
2020-08-13,3,6,9,0,1,1,10,11,21,35,14,49,89,52,141,175,88,263,353,141,494,427,336,763,446,545,991,166,430,596,1704,1624,3328
2020-08-14,3,6,9,0,1,1,10,11,21,35,14,49,90,52,142,176,88,264,357,142,499,432,339,771,451,550,1001,166,433,599,1720,1636,3356
2020-08-15,3,6,9,0,1,1,10,12,22,35,14,49,91,52,143,177,88,265,361,144,505,441,343,784,460,562,1022,166,441,607,1744,1663,3407
2020-08-16,3,6,9,0,1,1,10,12,22,35,14,49,93,52,145,177,89,266,364,144,508,445,347,792,467,568,1035,166,447,613,1760,1680,3440
2020-08-17,3,6,9,0,1,1,10,12,22,35,15,50,94,52,146,179,90,269,369,145,514,448,349,797,470,571,1041,166,451,617,1774,1692,3466
2020-08-18,3,6,9,0,1,1,12,12,24,35,15,50,94,52,146,181,91,272,372,146,518,457,351,808,473,589,1062,168,457,625,1795,1720,3515
2020-08-19,3,6,9,0,1,1,12,13,25,36,15,51,95,52,147,183,92,275,382,147,529,460,359,819,484,599,1083,173,459,632,1828,1743,3571
2020-08-20,3,6,9,0,1,1,12,13,25,38,15,53,96,52,148,183,92,275,393,147,540,464,365,829,494,603,1097,175,466,641,1858,1760,3618
2020-08-21,3,6,9,0,1,1,12,14,26,38,15,53,98,52,150,184,92,276,401,147,548,465,370,835,498,613,1111,177,472,649,1876,1782,3658
2020-08-22,3,6,9,0,1,1,12,14,26,38,15,53,99,52,151,185,92,277,407,149,556,469,375,844,503,617,1120,178,474,652,1894,1795,3689
2020-08-23,3,6,9,0,1,1,12,14,26,39,15,54,99,52,151,187,93,280,412,153,565,473,378,851,512,621,1133,182,480,662,1919,1813,3732
2020-08-24,3,6,9,0,1,1,13,14,27,40,15,55,100,52,152,189,93,282,416,159,575,478,382,860,517,623,1140,184,485,669,1940,1830,3770
2020-08-25,3,6,9,0,1,1,13,14,27,42,15,57,101,52,153,193,94,287,418,166,584,485,388,873,529,633,1162,186,489,675,1970,1858,3828
2020-08-26,3,6,9,0,1,1,13,14,27,42,16,58,102,55,157,195,94,289,423,168,591,492,393,885,535,641,1176,188,498,686,1993,1886,3879
2020-08-27,3,6,9,0,1,1,13,14,27,43,16,59,103,56,159,199,94,293,425,170,595,500,394,894,540,653,1193,193,502,695,2019,1906,3925
2020-08-28,3,6,9,0,1,1,13,14,27,43,16,59,104,56,160,203,94,297,428,172,600,509,398,907,544,660,1204,193,503,696,2040,1920,3960
2020-08-29,3,6,9,0,1,1,13,14,27,45,16,61,104,56,160,205,95,300,430,173,603,515,402,917,550,661,1211,194,506,700,2059,1930,3989
2020-08-30,3,6,9,0,1,1,13,14,27,46,16,62,104,57,161,208,95,303,437,173,610,522,406,928,555,665,1220,196,510,706,2084,1943,4027
2020-08-31,3,6,9,0,1,1,13,14,27,46,16,62,105,57,162,209,96,305,446,174,620,536,410,946,563,671,1234,196,511,707,2117,1956,4073
2020-09-01,3,6,9,0,1,1,13,14,27,46,16,62,106,57,163,209,96,305,454,175,629,545,413,958,568,680,1248,199,516,715,2143,1974,4117
2020-09-02,3,6,9,0,2,2,13,14,27,46,16,62,106,57,163,212,100,312,459,176,635,549,417,966,576,688,1264,199,519,718,2163,1995,4158
2020-09-03,3,6,9,0,2,2,13,14,27,46,16,62,107,59,166,213,100,313,465,177,642,556,424,980,584,693,1277,201,525,726,2188,2016,4204
2020-09-04,3,6,9,0,2,2,13,15,28,46,17,63,109,59,168,214,101,315,466,180,646,557,430,987,586,697,1283,202,527,729,2196,2034,4230
2020-09-05,3,6,9,0,2,2,13,15,28,46,17,63,109,60,169,215,102,317,472,184,656,564,433,997,591,706,1297,202,530,732,2215,2055,4270
2020-09-06,3,6,9,0,2,2,13,15,28,46,17,63,110,60,170,217,102,319,476,184,660,572,437,1009,594,711,1305,205,534,739,2236,2068,4304
2020-09-07,3,6,9,0,2,2,13,15,28,46,17,63,111,61,172,219,102,321,481,190,671,581,443,1024,604,718,1322,206,539,745,2264,2093,4357
2020-09-08,3,6,9,0,2,2,13,15,28,46,17,63,111,61,172,221,103,324,486,193,679,591,448,1039,614,728,1342,208,544,752,2293,2117,4410
2020-09-09,3,6,9,0,2,2,14,15,29,46,17,63,112,62,174,226,104,330,492,196,688,599,451,1050,616,731,1347,211,552,763,2319,2136,4455
2020-09-10,3,6,9,0,2,2,14,16,30,46,17,63,112,62,174,227,104,331,494,198,692,611,453,1064,620,739,1359,212,558,770,2339,2155,4494
2020-09-11,3,6,9,0,2,2,14,16,30,47,17,64,113,63,176,228,104,332,498,200,698,616,458,1074,623,746,1369,212,560,772,2354,2172,4526
2020-09-12,3,6,9,0,2,2,14,16,30,47,17,64,113,63,176,229,106,335,500,202,702,620,462,1082,626,749,1375,212,567,779,2364,2190,4554
2020-09-13,3,6,9,0,2,2,14,16,30,47,17,64,114,63,177,229,106,335,504,204,708,624,464,1088,627,753,1380,212,568,780,2374,2199,4573
2020-09-14,3,6,9,0,2,2,15,16,31,48,17,65,114,63,177,231,106,337,505,205,710,631,470,1101,632,755,1387,213,572,785,2392,2212,4604
2020-09-15,3,6,9,0,2,2,15,16,31,48,17,65,114,63,177,233,107,340,508,207,715,636,473,1109,637,758,1395,214,575,789,2408,2224,4632
2020-09-16,3,6,9,0,2,2,15,16,31,50,17,67,114,63,177,233,108,341,512,208,720,640,478,1118,640,764,1404,215,579,794,2422,2241,4663
2020-09-17,3,6,9,0,2,2,15,16,31,50,17,67,114,63,177,233,108,341,514,209,723,646,480,1126,644,768,1412,217,583,800,2436,2252,4688
2020-09-18,3,6,9,0,2,2,16,17,33,51,17,68,114,64,178,233,109,342,518,210,728,647,483,1130,649,773,1422,217,586,803,2448,2267,4715
2020-09-19,3,6,9,0,2,2,16,17,33,51,17,68,114,64,178,234,109,343,520,212,732,651,486,1137,651,778,1429,217,589,806,2457,2280,4737
2020-09-20,3,6,9,0,2,2,16,17,33,51,17,68,117,64,181,235,109,344,523,213,736,652,489,1141,653,780,1433,217,591,808,2467,2288,4755
2020-09-21,3,6,9,0,2,2,16,17,33,51,17,68,118,64,182,235,109,344,525,213,738,657,493,1150,655,784,1439,217,593,810,2477,2298,4775
2020-09-22,3,6,9,0,2,2,16,17,33,51,17,68,118,64,182,236,110,346,528,216,744,660,494,1154,660,789,1449,218,596,814,2490,2311,4801
2020-09-23,3,6,9,0,2,2,16,17,33,51,17,68,118,65,183,240,110,350,529,219,748,666,498,1164,662,793,1455,219,598,817,2504,2325,4829
2020-09-24,3,6,9,0,2,2,16,17,33,51,17,68,118,65,183,243,111,354,531,219,750,668,500,1168,666,797,1463,221,599,820,2517,2333,4850
2020-09-25,3,6,9,0,2,2,16,17,33,51,18,69,118,66,184,245,111,356,534,219,753,675,507,1182,668,802,1470,223,605,828,2533,2353,4886
2020-09-26,3,6,9,0,2,2,16,17,33,51,18,69,118,66,184,245,111,356,535,220,755,681,509,1190,672,805,1477,224,606,830,2545,2360,4905
2020-09-27,3,6,9,0,2,2,16,17,33,51,18,69,118,66,184,245,111,356,537,221,758,685,513,1198,675,809,1484,225,608,833,2555,2371,4926
2020-09-28,3,6,9,0,2,2,16,17,33,51,18,69,118,68,186,247,111,358,543,223,766,688,514,1202,681,811,1492,228,608,836,2575,2378,4953
2020-09-29,3,6,9,0,2,2,16,17,33,52,18,70,118,68,186,248,111,359,547,224,771,691,517,1208,684,817,1501,229,610,839,2588,2390,4978
2020-09-30,3,6,9,0,2,2,17,17,34,52,18,70,118,69,187,248,111,359,551,227,778,697,517,1214,687,821,1508,232,613,845,2605,2401,5006
2020-10-01,4,6,10,0,2,2,17,17,34,52,18,70,119,69,188,249,111,360,557,230,787,699,522,1221,689,825,1514,233,615,848,2619,2415,5034
2020-10-02,4,6,10,0,2,2,17,17,34,52,18,70,119,70,189,250,111,361,560,232,792,702,528,1230,691,828,1519,235,617,852,2630,2429,5059
2020-10-03,4,6,10,0,2,2,18,17,35,52,18,70,119,70,189,250,111,361,561,232,793,706,528,1234,691,830,1521,236,617,853,2637,2431,5068
2020-10-04,4,6,10,0,2,2,18,17,35,52,18,70,120,70,190,252,111,363,562,232,794,707,530,1237,695,831,1526,236,618,854,2646,2435,5081
2020-10-05,4,6,10,0,2,2,18,17,35,52,18,70,121,70,191,254,111,365,565,234,799,710,533,1243,698,836,1534,236,620,856,2658,2447,5105
2020-10-06,4,6,10,0,2,2,18,17,35,52,18,70,121,71,192,254,111,365,566,235,801,712,534,1246,705,838,1543,237,620,857,2669,2452,5121
2020-10-07,4,6,10,0,2,2,18,17,35,52,18,70,121,71,192,254,111,365,567,235,802,713,539,1252,709,841,1550,237,622,859,2675,2462,5137
2020-10-08,4,6,10,0,2,2,18,17,35,52,18,70,121,71,192,254,111,365,569,235,804,717,544,1261,714,849,1563,238,624,862,2687,2477,5164
2020-10-09,4,6,10,0,2,2,18,17,35,52,18,70,121,71,192,258,112,370,572,236,808,721,544,1265,718,854,1572,239,625,864,2703,2485,5188
2020-10-10,4,6,10,0,2,2,18,17,35,52,18,70,123,71,194,258,112,370,573,236,809,724,546,1270,723,857,1580,239,625,864,2714,2490,5204
2020-10-11,4,6,10,0,2,2,18,17,35,53,18,71,124,72,196,259,112,371,573,237,810,727,548,1275,725,858,1583,240,625,865,2723,2495,5218
2020-10-12,4,6,10,0,2,2,18,17,35,53,18,71,125,72,197,260,112,372,575,238,813,730,549,1279,728,860,1588,240,625,865,2733,2499,5232
2020-10-13,4,6,10,0,2,2,18,17,35,53,18,71,125,72,197,263,112,375,579,240,819,731,549,1280,732,866,1598,241,626,867,2746,2508,5254
2020-10-14,4,6,10,0,2,2,19,17,36,53,18,71,126,72,198,265,112,377,580,241,821,734,552,1286,735,870,1605,242,628,870,2758,2518,5276
2020-10-15,4,6,10,0,2,2,19,17,36,53,18,71,128,72,200,265,114,379,581,241,822,737,554,1291,738,873,1611,242,629,871,2767,2526,5293
2020-10-16,4,6,10,0,2,2,19,17,36,53,18,71,129,72,201,266,114,380,583,242,825,740,555,1295,742,876,1618,243,635,878,2779,2537,5316
2020-10-17,4,6,10,0,2,2,19,18,37,53,18,71,129,74,203,266,115,381,586,243,829,743,556,1299,746,876,1622,245,637,882,2791,2545,5336
2020-10-18,4,6,10,0,2,2,20,18,38,54,18,72,129,74,203,267,115,382,586,243,829,745,558,1303,746,877,1623,245,638,883,2796,2549,5345
2020-10-19,4,7,11,0,2,2,20,18,38,54,18,72,130,74,204,267,115,382,586,244,830,748,561,1309,746,880,1626,245,638,883,2800,2557,5357
2020-10-20,4,7,11,0,2,2,20,18,38,55,18,73,130,75,205,268,115,383,586,245,831,751,562,1313,752,882,1634,246,638,884,2812,2562,5374
2020-10-21,4,7,11,0,2,2,20,18,38,55,18,73,130,75,205,269,116,385,589,247,836,753,562,1315,753,882,1635,246,638,884,2819,2565,5384
2020-10-22,4,7,11,0,2,2,20,18,38,55,18,73,130,75,205,270,116,386,589,248,837,755,564,1319,754,883,1637,246,638,884,2823,2569,5392
2020-10-23,4,7,11,0,2,2,20,18,38,55,18,73,130,75,205,271,116,387,592,250,842,756,567,1323,758,887,1645,247,639,886,2833,2579,5412
2020-10-24,4,7,11,0,2,2,20,18,38,55,18,73,130,75,205,273,116,389,594,250,844,757,570,1327,758,888,1646,247,641,888,2838,2585,5423
2020-10-25,4,7,11,0,2,2,20,18,38,56,18,74,130,75,205,273,116,389,595,251,846,758,570,1328,759,890,1649,247,642,889,2842,2589,5431
2020-10-26,4,7,11,0,2,2,20,18,38,56,18,74,130,75,205,274,116,390,598,251,849,761,572,1333,763,894,1657,249,643,892,2855,2596,5451
2020-10-27,4,7,11,0,2,2,20,18,38,56,18,74,130,76,206,277,117,394,599,251,850,763,574,1337,766,897,1663,250,643,893,2865,2603,5468
2020-10-28,4,7,11,0,2,2,21,18,39,56,18,74,130,76,206,278,117,395,600,251,851,765,574,1339,768,898,1666,252,644,896,2874,2605,5479
2020-10-29,4,7,11,0,2,2,21,18,39,56,18,74,131,76,207,278,118,396,601,251,852,767,574,1341,770,899,1669,252,644,896,2880,2607,5487
2020-10-30,4,7,11,0,2,2,21,18,39,56,18,74,131,76,207,278,119,397,602,252,854,769,574,1343,772,900,1672,253,645,898,2886,2611,5497
2020-10-31,4,7,11,0,2,2,21,18,39,56,18,74,131,76,207,278,119,397,603,252,855,770,575,1345,772,900,1672,253,645,898,2888,2612,5500
2020-11-01,4,7,11,0,2,2,21,18,39,56,18,74,131,76,207,278,119,397,603,252,855,770,576,1346,774,901,1675,253,645,898,2890,2614,5504
2020-11-02,4,7,11,0,2,2,21,18,39,56,18,74,131,76,207,279,119,398,603,252,855,770,576,1346,774,901,1675,253,646,899,2891,2615,5506
2020-11-03,4,7,11,0,2,2,21,18,39,56,18,74,131,76,207,279,119,398,603,253,856,771,579,1350,774,903,1677,253,647,900,2892,2622,5514
2020-11-04,4,7,11,0,2,2,21,18,39,56,18,74,131,76,207,279,120,399,604,253,857,772,580,1352,775,905,1680,253,648,901,2895,2627,5522
2020-11-05,4,7,11,0,2,2,21,18,39,56,18,74,131,76,207,279,120,399,607,253,860,774,582,1356,775,906,1681,254,648,902,2901,2630,5531
2020-11-06,4,7,11,0,2,2,21,18,39,56,18,74,131,77,208,279,120,399,610,253,863,776,583,1359,778,909,1687,256,648,904,2911,2635,5546
2020-11-07,4,7,11,0,2,2,21,18,39,56,18,74,131,77,208,279,120,399,610,255,865,776,585,1361,779,909,1688,256,648,904,2912,2639,5551
2020-11-08,4,7,11,0,2,2,21,18,39,56,18,74,131,77,208,279,120,399,611,255,866,777,585,1362,781,910,1691,257,648,905,2917,2640,5557
2020-11-09,4,7,11,0,2,2,21,19,40,56,18,74,131,77,208,279,120,399,612,256,868,783,586,1369,782,915,1697,257,650,907,2925,2650,5575
2020-11-10,4,7,11,0,2,2,21,19,40,56,18,74,131,77,208,280,120,400,615,256,871,784,591,1375,782,920,1702,257,650,907,2930,2660,5590
2020-11-11,4,7,11,0,2,2,21,19,40,56,18,74,131,77,208,282,121,403,615,256,871,785,593,1378,782,922,1704,258,651,909,2934,2666,5600
2020-11-12,4,7,11,0,2,2,21,19,40,56,18,74,131,77,208,282,121,403,616,256,872,786,593,1379,782,922,1704,258,653,911,2936,2668,5604
2020-11-13,4,7,11,0,2,2,21,19,40,56,18,74,131,77,208,283,121,404,617,256,873,789,593,1382,783,925,1708,259,654,913,2943,2672,5615
2020-11-14,4,7,11,0,2,2,21,19,40,56,18,74,131,77,208,284,121,405,618,256,874,792,593,1385,785,927,1712,259,654,913,2950,2674,5624
2020-11-15,4,7,11,0,2,2,21,19,40,56,18,74,131,77,208,284,121,405,620,256,876,793,594,1387,786,929,1715,260,654,914,2955,2677,5632
2020-11-16,4,7,11,0,2,2,21,19,40,56,18,74,131,77,208,284,121,405,622,256,878,794,594,1388,788,931,1719,262,656,918,2962,2681,5643
2020-11-17,4,7,11,0,2,2,21,19,40,56,18,74,131,77,208,285,121,406,626,256,882,795,594,1389,790,935,1725,262,657,919,2970,2686,5656
2020-11-18,4,7,11,0,2,2,21,19,40,56,18,74,131,77,208,285,121,406,627,256,883,798,594,1392,792,935,1727,262,658,920,2976,2687,5663
2020-11-19,4,7,11,0,2,2,21,19,40,56,18,74,131,78,209,285,121,406,627,256,883,800,594,1394,793,936,1729,262,659,921,2979,2690,5669
2020-11-20,4,7,11,0,2,2,21,19,40,56,18,74,131,78,209,285,121,406,628,256,884,801,595,1396,796,937,1733,263,659,922,2985,2692,5677
2020-11-21,4,7,11,0,2,2,21,19,40,56,18,74,131,78,209,285,121,406,628,256,884,802,595,1397,797,938,1735,263,659,922,2987,2693,5680
2020-11-22,4,7,11,0,2,2,21,19,40,56,18,74,131,78,209,286,121,407,630,256,886,803,598,1401,798,938,1736,263,660,923,2992,2697,5689
2020-11-23,4,7,11,0,2,2,21,19,40,56,18,74,131,78,209,286,121,407,630,256,886,805,600,1405,798,940,1738,263,661,924,2994,2702,5696
2020-11-24,4,7,11,0,2,2,21,19,40,56,18,74,131,78,209,286,121,407,632,256,888,806,600,1406,800,940,1740,263,662,925,2999,2703,5702
2020-11-25,4,7,11,0,2,2,21,19,40,56,18,74,133,78,211,286,121,407,633,257,890,807,601,1408,801,941,1742,264,663,927,3005,2707,5712
2020-11-26,4,7,11,0,2,2,21,19,40,58,18,76,133,78,211,286,121,407,634,257,891,807,601,1408,802,942,1744,265,664,929,3010,2709,5719
2020-11-27,4,7,11,0,2,2,21,19,40,58,18,76,133,78,211,287,121,408,635,257,892,808,603,1411,802,942,1744,266,666,932,3014,2713,5727
2020-11-28,4,7,11,0,2,2,21,19,40,58,18,76,134,78,212,287,121,408,636,257,893,808,604,1412,803,943,1746,266,666,932,3017,2715,5732
2020-11-29,4,7,11,0,2,2,21,19,40,58,18,76,134,78,212,287,121,408,637,257,894,809,604,1413,803,944,1747,267,666,933,3020,2716,5736
2020-11-30,4,7,11,0,2,2,21,19,40,58,18,76,134,78,212,287,121,408,637,257,894,810,605,1415,803,945,1748,267,667,934,3021,2719,5740
2020-12-01,4,7,11,0,2,2,21,19,40,58,18,76,134,78,212,288,121,409,637,257,894,810,607,1417,804,945,1749,267,667,934,3023,2721,5744
2020-12-02,4,7,11,0,2,2,21,19,40,58,18,76,134,78,212,288,121,409,639,259,898,810,609,1419,805,947,1752,267,672,939,3026,2732,5758
2020-12-03,4,7,11,0,2,2,21,19,40,58,18,76,134,78,212,289,121,410,640,259,899,811,611,1422,807,947,1754,267,672,939,3031,2734,5765
2020-12-04,4,7,11,0,2,2,21,19,40,58,18,76,134,78,212,289,121,410,642,259,901,812,612,1424,810,948,1758,268,672,940,3038,2736,5774
2020-12-05,4,7,11,0,2,2,21,19,40,58,18,76,134,78,212,289,121,410,642,259,901,812,613,1425,815,950,1765,268,672,940,3043,2739,5782
2020-12-06,4,7,11,0,2,2,21,19,40,58,18,76,134,78,212,289,121,410,643,259,902,813,614,1427,816,951,1767,268,672,940,3046,2741,5787
2020-12-07,4,7,11,0,2,2,21,19,40,58,18,76,134,78,212,290,121,411,644,260,904,815,615,1430,818,952,1770,268,672,940,3052,2744,5796
2020-12-08,4,7,11,0,2,2,21,19,40,58,18,76,134,78,212,290,121,411,647,261,908,816,618,1434,819,953,1772,269,673,942,3058,2750,5808
2020-12-09,4,7,11,0,2,2,21,19,40,58,19,77,134,78,212,290,121,411,649,261,910,816,619,1435,819,953,1772,269,673,942,3060,2752,5812
2020-12-10,4,7,11,0,2,2,21,19,40,58,19,77,134,78,212,292,121,413,650,261,911,819,622,1441,820,956,1776,269,675,944,3067,2760,5827
2020-12-11,4,7,11,0,2,2,21,19,40,58,19,77,134,78,212,292,122,414,651,261,912,819,623,1442,821,959,1780,269,676,945,3069,2766,5835
2020-12-12,4,7,11,0,2,2,21,19,40,58,19,77,134,78,212,292,123,415,651,261,912,821,623,1444,822,959,1781,269,676,945,3072,2767,5839
2020-12-13,4,7,11,0,2,2,21,19,40,58,19,77,135,78,213,292,123,415,652,262,914,823,623,1446,825,959,1784,270,676,946,3080,2768,5848
2020-12-14,4,7,11,0,2,2,21,19,40,58,19,77,135,78,213,292,123,415,655,263,918,826,624,1450,826,960,1786,270,676,946,3087,2771,5858
2020-12-15,4,7,11,0,2,2,21,19,40,58,19,77,135,78,213,292,123,415,657,263,920,828,626,1454,827,960,1787,270,677,947,3092,2774,5866
2020-12-16,4,7,11,0,2,2,21,19,40,58,19,77,135,78,213,292,123,415,658,264,922,831,628,1459,830,963,1793,271,678,949,3100,2781,5881
2020-12-17,4,7,11,0,2,2,21,19,40,58,19,77,135,78,213,293,123,416,658,264,922,833,632,1465,830,963,1793,271,680,951,3103,2787,5890
2020-12-18,4,7,11,0,2,2,21,19,40,59,19,78,135,78,213,295,123,418,658,265,923,837,632,1469,830,967,1797,271,683,954,3110,2795,5905
2020-12-19,4,7,11,0,2,2,21,19,40,59,19,78,135,78,213,296,123,419,660,266,926,839,632,1471,830,969,1799,271,684,955,3115,2799,5914
2020-12-20,4,7,11,0,2,2,21,19,40,59,19,78,135,78,213,296,123,419,662,268,930,840,632,1472,831,969,1800,273,685,958,3121,2802,5923
2020-12-21,4,7,11,0,2,2,21,19,40,59,19,78,136,78,214,298,123,421,665,269,934,843,633,1476,833,972,1805,274,687,961,3133,2809,5942
2020-12-22,4,7,11,0,2,2,21,19,40,59,19,78,136,78,214,299,123,422,667,269,936,844,634,1478,833,973,1806,274,688,962,3137,2812,5949
2020-12-23,4,7,11,0,2,2,21,19,40,59,19,78,136,79,215,301,123,424,670,269,939,848,637,1485,836,976,1812,274,688,962,3149,2819,5968
2020-12-24,4,7,11,0,2,2,21,19,40,59,19,78,136,79,215,301,123,424,671,269,940,848,637,1485,837,977,1814,274,689,963,3151,2821,5972
2020-12-25,4,7,11,0,2,2,21,19,40,59,19,78,137,80,217,302,123,425,672,270,942,850,637,1487,837,977,1814,274,690,964,3156,2824,5980
2020-12-26,4,7,11,0,2,2,21,19,40,59,20,79,137,80,217,304,123,427,672,270,942,854,640,1494,838,979,1817,275,691,966,3164,2831,5995
2020-12-27,4,7,11,0,2,2,21,19,40,59,20,79,138,80,218,305,123,428,675,270,945,858,641,1499,840,980,1820,275,691,966,3175,2833,6008
2020-12-28,4,7,11,0,2,2,21,19,40,59,20,79,139,80,219,306,123,429,677,271,948,864,643,1507,846,985,1831,276,692,968,3192,2842,6034
2020-12-29,4,7,11,0,2,2,21,19,40,59,20,79,139,80,219,306,124,430,682,272,954,867,644,1511,850,986,1836,278,693,971,3206,2847,6053
2020-12-30,4,7,11,0,2,2,21,19,40,59,20,79,139,80,219,308,124,432,682,273,955,871,646,1517,851,988,1839,278,693,971,3213,2852,6065
2020-12-31,4,7,11,0,2,2,21,19,40,59,20,79,139,80,219,309,124,433,683,274,957,873,648,1521,853,990,1843,278,693,971,3219,2857,6076
2021-01-01,4,7,11,0,2,2,21,19,40,59,20,79,139,80,219,309,124,433,685,275,960,876,650,1526,853,990,1843,278,693,971,3224,2860,6084
2021-01-02,4,7,11,0,2,2,21,19,40,59,20,79,140,80,220,310,126,436,685,278,963,876,650,1526,855,991,1846,281,693,974,3231,2866,6097
2021-01-03,4,7,11,0,2,2,21,19,40,59,20,79,140,80,220,313,128,441,685,278,963,878,651,1529,856,993,1849,281,693,974,3237,2871,6108
2021-01-04,4,7,11,0,2,2,21,19,40,59,20,79,140,80,220,314,128,442,686,279,965,883,651,1534,863,1000,1863,283,695,978,3253,2881,6134
2021-01-05,4,7,11,0,2,2,21,19,40,59,21,80,141,80,221,314,128,442,689,280,969,884,651,1535,864,1002,1866,283,699,982,3259,2889,6148
2021-01-06,4,7,11,0,2,2,21,19,40,59,21,80,143,80,223,316,129,445,693,280,973,890,653,1543,864,1005,1869,283,699,982,3273,2895,6168
2021-01-07,4,7,11,0,2,2,22,19,41,59,21,80,143,81,224,316,130,446,695,282,977,894,656,1550,868,1007,1875,288,700,988,3289,2905,6194
2021-01-08,4,7,11,0,2,2,22,19,41,59,21,80,143,81,224,319,131,450,701,283,984,897,659,1556,870,1011,1881,288,701,989,3303,2915,6218
2021-01-09,4,7,11,0,2,2,22,19,41,59,21,80,144,81,225,320,132,452,701,283,984,900,662,1562,870,1014,1884,288,702,990,3308,2923,6231
2021-01-10,4,7,11,0,2,2,22,19,41,59,21,80,144,81,225,322,132,454,704,284,988,903,663,1566,872,1015,1887,288,702,990,3318,2926,6244
2021-01-11,4,7,11,0,2,2,22,19,41,59,22,81,145,81,226,324,132,456,710,284,994,908,664,1572,873,1018,1891,288,705,993,3333,2934,6267
2021-01-12,4,7,11,0,2,2,22,19,41,59,22,81,145,81,226,325,132,457,714,286,1000,913,665,1578,876,1021,1897,288,708,996,3346,2943,6289
2021-01-13,4,7,11,0,2,2,22,19,41,59,22,81,145,81,226,330,135,465,716,287,1003,917,665,1582,879,1023,1902,289,710,999,3361,2951,6312
2021-01-14,4,7,11,0,2,2,22,19,41,59,22,81,145,81,226,332,135,467,719,289,1008,923,668,1591,884,1023,1907,291,710,1001,3379,2956,6335
2021-01-15,4,7,11,0,2,2,22,19,41,60,22,82,145,82,227,333,135,468,721,290,1011,924,672,1596,889,1025,1914,291,710,1001,3389,2964,6353
2021-01-16,4,7,11,0,2,2,22,19,41,60,22,82,145,82,227,333,135,468,721,291,1012,926,675,1601,890,1027,1917,291,710,1001,3392,2970,6362
2021-01-17,4,7,11,0,2,2,22,19,41,60,23,83,145,82,227,333,135,468,723,291,1014,932,675,1607,891,1028,1919,293,710,1003,3403,2972,6375
2021-01-18,4,7,11,0,2,2,22,19,41,60,23,83,145,82,227,333,135,468,726,294,1020,935,677,1612,893,1033,1926,294,711,1005,3412,2983,6395
2021-01-19,4,7,11,0,2,2,22,19,41,60,23,83,145,82,227,335,135,470,728,294,1022,937,679,1616,899,1037,1936,294,713,1007,3424,2991,6415
2021-01-20,4,7,11,0,2,2,22,19,41,60,24,84,145,82,227,337,135,472,732,295,1027,941,679,1620,903,1041,1944,294,717,1011,3438,3001,6439
2021-01-21,4,7,11,0,2,2,22,19,41,60,24,84,146,82,228,340,136,476,736,297,1033,944,681,1625,907,1047,1954,296,718,1014,3455,3013,6468
2021-01-22,4,7,11,0,2,2,22,19,41,60,24,84,146,82,228,340,136,476,740,299,1039,945,682,1627,908,1050,1958,297,719,1016,3462,3020,6482
2021-01-23,4,7,11,0,2,2,22,19,41,60,24,84,146,82,228,340,136,476,740,299,1039,951,688,1639,909,1053,1962,297,719,1016,3469,3029,6498
2021-01-24,4,7,11,0,2,2,22,19,41,60,24,84,146,82,228,340,136,476,741,299,1040,953,690,1643,910,1053,1963,297,719,1016,3473,3031,6504
2021-01-25,4,7,11,0,2,2,22,19,41,60,25,85,146,82,228,341,136,477,742,300,1042,957,693,1650,912,1056,1968,298,720,1018,3482,3040,6522
2021-01-26,4,7,11,0,2,2,22,19,41,60,25,85,147,82,229,342,137,479,745,301,1046,959,696,1655,916,1059,1975,298,722,1020,3493,3050,6543
2021-01-27,4,7,11,0,2,2,22,19,41,60,25,85,148,82,230,342,137,479,746,302,1048,962,697,1659,919,1063,1982,299,723,1022,3502,3057,6559
2021-01-28,4,7,11,0,2,2,22,19,41,60,25,85,148,82,230,342,137,479,747,303,1050,964,700,1664,921,1064,1985,299,724,1023,3507,3063,6570
2021-01-29,4,7,11,0,2,2,22,19,41,60,25,85,148,83,231,343,137,480,749,303,1052,968,700,1668,923,1068,1991,301,725,1026,3518,3069,6587
2021-01-30,4,7,11,0,2,2,22,19,41,60,25,85,148,83,231,345,137,482,751,304,1055,968,702,1670,923,1070,1993,302,725,1027,3523,3074,6597
2021-01-31,4,7,11,0,2,2,22,19,41,60,25,85,148,83,231,346,137,483,751,304,1055,974,704,1678,923,1071,1994,302,726,1028,3530,3078,6608
2021-02-01,4,7,11,0,2,2,22,19,41,60,25,85,148,83,231,347,138,485,754,306,1060,978,707,1685,926,1074,2000,302,727,1029,3541,3088,6629
2021-02-02,4,7,11,0,2,2,22,19,41,60,25,85,148,83,231,348,140,488,755,307,1062,981,710,1691,928,1079,2007,302,729,1031,3548,3101,6649
2021-02-03,4,7,11,0,2,2,22,19,41,60,25,85,150,83,233,348,140,488,757,310,1067,984,711,1695,932,1080,2012,303,729,1032,3560,3106,6666
2021-02-04,4,7,11,0,2,2,22,19,41,60,25,85,151,84,235,349,140,489,763,312,1075,990,715,1705,936,1083,2019,303,731,1034,3578,3118,6696
2021-02-05,4,7,11,0,2,2,22,19,41,60,25,85,151,84,235,350,140,490,765,313,1078,993,716,1709,938,1084,2022,303,733,1036,3586,3123,6709
2021-02-06,4,7,11,0,2,2,22,19,41,60,25,85,151,85,236,350,141,491,767,315,1082,997,718,1715,939,1084,2023,303,734,1037,3593,3130,6723
2021-02-07,4,7,11,0,2,2,22,19,41,60,25,85,151,85,236,350,142,492,768,317,1085,1002,719,1721,943,1086,2029,303,735,1038,3603,3137,6740
2021-02-08,4,7,11,0,2,2,22,19,41,60,25,85,151,85,236,353,142,495,772,317,1089,1008,726,1734,946,1090,2036,303,737,1040,3619,3150,6769
2021-02-09,4,7,11,0,2,2,22,19,41,60,25,85,152,85,237,353,142,495,773,319,1092,1009,729,1738,949,1091,2040,303,737,1040,3625,3156,6781
2021-02-10,4,7,11,0,2,2,22,19,41,61,25,86,152,85,237,354,142,496,774,320,1094,1011,732,1743,949,1094,2043,304,738,1042,3631,3164,6795
2021-02-11,4,7,11,0,2,2,22,19,41,61,25,86,152,85,237,354,142,496,776,321,1097,1015,733,1748,950,1094,2044,305,739,1044,3639,3167,6806
2021-02-12,4,7,11,0,2,2,22,19,41,61,25,86,153,85,238,354,143,497,778,323,1101,1018,738,1756,953,1097,2050,307,740,1047,3650,3179,6829
2021-02-13,4,7,11,0,2,2,22,19,41,61,25,86,153,86,239,354,143,497,779,323,1102,1023,741,1764,953,1100,2053,308,741,1049,3657,3187,6844
2021-02-14,4,7,11,0,2,2,22,19,41,61,25,86,153,86,239,354,143,497,780,323,1103,1026,745,1771,953,1101,2054,308,741,1049,3661,3192,6853
2021-02-15,4,7,11,0,2,2,22,19,41,62,25,87,154,86,240,354,143,497,782,323,1105,1027,746,1773,955,1102,2057,308,742,1050,3668,3195,6863
2021-02-16,4,7,11,0,2,2,22,19,41,62,25,87,154,86,240,354,143,497,782,323,1105,1030,747,1777,957,1105,2062,308,746,1054,3673,3203,6876
2021-02-17,4,7,11,0,2,2,22,19,41,62,25,87,154,86,240,354,143,497,783,323,1106,1032,747,1779,960,1107,2067,308,746,1054,3679,3205,6884
2021-02-18,4,7,11,0,2,2,22,19,41,63,25,88,154,86,240,355,144,499,786,324,1110,1035,748,1783,960,1109,2069,308,746,1054,3687,3210,6897
2021-02-19,4,7,11,0,2,2,22,19,41,63,25,88,154,86,240,358,146,504,787,326,1113,1036,748,1784,961,1109,2070,308,746,1054,3693,3214,6907
2021-02-20,4,7,11,0,2,2,22,19,41,63,25,88,155,86,241,358,146,504,788,326,1114,1037,749,1786,962,1111,2073,309,747,1056,3698,3218,6916
2021-02-21,4,7,11,0,2,2,22,19,41,63,26,89,155,86,241,358,146,504,790,326,1116,1038,751,1789,964,1112,2076,309,748,1057,3703,3223,6926
2021-02-22,4,7,11,0,2,2,22,19,41,63,26,89,155,86,241,359,146,505,792,327,1119,1040,753,1793,966,1114,2080,311,748,1059,3712,3228,6940
2021-02-23,4,7,11,0,2,2,22,19,41,63,26,89,155,86,241,360,147,507,792,327,1119,1042,755,1797,969,1116,2085,312,748,1060,3719,3233,6952
2021-02-24,4,7,11,0,2,2,22,19,41,63,27,90,155,86,241,361,147,508,793,328,1121,1044,756,1800,969,1116,2085,314,751,1065,3725,3239,6964
2021-02-25,4,7,11,0,2,2,22,19,41,63,27,90,155,86,241,362,147,509,795,328,1123,1047,758,1805,970,1116,2086,315,751,1066,3733,3241,6974
2021-02-26,4,7,11,0,2,2,22,19,41,63,27,90,155,86,241,363,147,510,795,329,1124,1051,759,1810,971,1120,2091,317,753,1070,3741,3249,6990
2021-02-27,4,7,11,0,2,2,22,19,41,63,27,90,155,86,241,365,147,512,795,329,1124,1052,761,1813,977,1123,2100,317,754,1071,3750,3255,7005
2021-02-28,4,7,11,0,2,2,22,19,41,63,27,90,155,86,241,366,147,513,796,329,1125,1052,761,1813,977,1124,2101,317,754,1071,3752,3256,7008
2021-03-01,4,7,11,0,2,2,22,19,41,63,27,90,155,86,241,367,147,514,797,329,1126,1054,765,1819,978,1128,2106,317,754,1071,3757,3264,7021
2021-03-02,4,7,11,0,2,2,22,19,41,63,27,90,156,86,242,367,147,514,799,330,1129,1057,766,1823,980,1129,2109,317,755,1072,3765,3268,7033
2021-03-03,4,7,11,0,2,2,22,19,41,63,27,90,157,86,243,368,147,515,800,331,1131,1058,767,1825,983,1129,2112,317,755,1072,3772,3270,7042
2021-03-04,4,7,11,1,2,3,22,19,41,63,27,90,157,86,243,369,147,516,801,333,1134,1061,768,1829,984,1129,2113,318,755,1073,3780,3273,7053
2021-03-05,4,7,11,1,2,3,22,19,41,63,27,90,158,86,244,370,148,518,803,333,1136,1064,769,1833,985,1131,2116,318,755,1073,3788,3277,7065
2021-03-06,4,7,11,1,2,3,22,19,41,63,27,90,158,86,244,370,148,518,804,333,1137,1065,770,1835,986,1131,2117,318,756,1074,3791,3279,7070
2021-03-07,4,7,11,1,2,3,22,19,41,63,27,90,158,86,244,370,148,518,805,335,1140,1067,770,1837,987,1131,2118,318,757,1075,3795,3282,7077
2021-03-08,4,7,11,1,2,3,22,19,41,63,27,90,158,86,244,370,150,520,807,335,1142,1069,770,1839,990,1132,2122,319,757,1076,3803,3285,7088
2021-03-09,4,7,11,1,2,3,22,19,41,63,27,90,158,86,244,373,150,523,809,336,1145,1073,770,1843,994,1134,2128,319,758,1077,3816,3289,7105
2021-03-10,4,7,11,1,2,3,22,19,41,63,27,90,159,86,245,373,150,523,810,340,1150,1078,775,1853,994,1136,2130,319,759,1078,3823,3301,7124
2021-03-11,4,7,11,1,2,3,22,19,41,63,27,90,159,86,245,375,150,525,814,340,1154,1080,776,1856,998,1138,2136,320,760,1080,3836,3305,7141
2021-03-12,4,7,11,1,2,3,22,19,41,63,27,90,159,87,246,376,151,527,814,340,1154,1088,779,1867,999,1142,2141,320,765,1085,3846,3319,7165
2021-03-13,4,7,11,1,2,3,22,19,41,63,27,90,159,87,246,376,151,527,815,340,1155,1090,782,1872,1002,1142,2144,320,765,1085,3852,3322,7174
2021-03-14,4,7,11,1,2,3,22,19,41,63,27,90,160,87,247,376,151,527,816,340,1156,1093,783,1876,1005,1143,2148,320,765,1085,3860,3324,7184
2021-03-15,4,7,11,1,2,3,22,19,41,63,27,90,160,87,247,377,151,528,817,343,1160,1095,784,1879,1005,1146,2151,320,767,1087,3864,3333,7197
2021-03-16,4,7,11,1,2,3,22,19,41,63,27,90,160,87,247,379,151,530,818,344,1162,1096,784,1880,1007,1151,2158,321,767,1088,3871,3339,7210
2021-03-17,4,7,11,1,2,3,22,19,41,63,27,90,160,87,247,379,151,530,821,344,1165,1100,787,1887,1008,1151,2159,321,769,1090,3879,3344,7223
2021-03-18,4,7,11,1,2,3,22,19,41,63,27,90,161,87,248,380,151,531,821,345,1166,1103,793,1896,1009,1153,2162,321,771,1092,3885,3355,7240
2021-03-19,4,7,11,1,2,3,22,19,41,63,27,90,162,87,249,381,152,533,825,348,1173,1104,797,1901,1010,1156,2166,321,771,1092,3893,3366,7259
2021-03-20,4,7,11,1,2,3,23,19,42,63,27,90,162,87,249,382,153,535,828,350,1178,1106,797,1903,1011,1157,2168,321,771,1092,3901,3370,7271
2021-03-21,4,7,11,1,2,3,23,19,42,63,27,90,162,87,249,385,153,538,828,350,1178,1110,799,1909,1013,1160,2173,321,771,1092,3910,3375,7285
2021-03-22,4,7,11,1,2,3,23,19,42,63,27,90,162,87,249,385,153,538,831,352,1183,1111,799,1910,1017,1162,2179,322,772,1094,3919,3380,7299
2021-03-23,4,7,11,1,2,3,23,19,42,63,27,90,163,87,250,386,154,540,834,353,1187,1118,803,1921,1019,1163,2182,322,773,1095,3933,3388,7321
2021-03-24,4,7,11,1,2,3,23,19,42,63,27,90,164,88,252,386,154,540,837,354,1191,1124,803,1927,1020,1163,2183,324,774,1098,3946,3391,7337
2021-03-25,4,7,11,1,2,3,23,19,42,64,27,91,164,89,253,386,156,542,839,356,1195,1128,807,1935,1024,1168,2192,324,774,1098,3957,3405,7362
2021-03-26,4,7,11,1,2,3,23,19,42,64,27,91,165,89,254,387,156,543,842,358,1200,1136,813,1949,1028,1169,2197,325,775,1100,3975,3415,7390
2021-03-27,4,7,11,1,2,3,23,19,42,65,27,92,165,90,255,389,156,545,846,359,1205,1143,816,1959,1035,1174,2209,326,777,1103,3997,3427,7424
2021-03-28,4,7,11,1,2,3,23,19,42,65,28,93,167,90,257,391,157,548,847,362,1209,1151,819,1970,1036,1174,2210,326,777,1103,4011,3435,7446
2021-03-29,4,7,11,1,2,3,23,19,42,65,28,93,167,90,257,396,158,554,854,364,1218,1163,823,1986,1042,1177,2219,328,780,1108,4043,3448,7491
2021-03-30,4,7,11,1,2,3,23,19,42,66,29,95,169,90,259,397,159,556,861,364,1225,1170,825,1995,1043,1182,2225,331,781,1112,4065,3458,7523
2021-03-31,4,7,11,1,2,3,23,19,42,66,29,95,169,91,260,401,159,560,868,366,1234,1175,833,2008,1045,1184,2229,331,782,1113,4083,3472,7555
2021-04-01,4,7,11,1,2,3,23,19,42,66,30,96,170,91,261,406,160,566,875,368,1243,1181,834,2015,1046,1186,2232,333,782,1115,4105,3479,7584
2021-04-02,4,7,11,1,2,3,23,19,42,67,30,97,172,91,263,409,160,569,881,372,1253,1185,837,2022,1047,1188,2235,334,782,1116,4123,3488,7611
2021-04-03,4,7,11,1,2,3,23,19,42,67,30,97,174,91,265,413,160,573,884,375,1259,1196,841,2037,1049,1188,2237,336,783,1119,4147,3496,7643
2021-04-04,5,7,12,1,2,3,24,19,43,67,31,98,174,91,265,415,161,576,892,377,1269,1204,843,2047,1052,1189,2241,337,784,1121,4171,3504,7675
2021-04-05,5,7,12,1,2,3,24,19,43,67,31,98,175,92,267,415,161,576,902,385,1287,1210,846,2056,1058,1195,2253,337,785,1122,4194,3523,7717
2021-04-06,5,7,12,1,2,3,24,19,43,67,31,98,176,92,268,420,165,585,909,388,1297,1220,852,2072,1065,1197,2262,339,788,1127,4226,3541,7767
2021-04-07,5,7,12,1,2,3,25,19,44,69,31,100,178,93,271,423,169,592,913,392,1305,1229,857,2086,1068,1198,2266,341,792,1133,4252,3560,7812
2021-04-08,5,7,12,1,2,3,25,19,44,69,31,100,179,93,272,428,171,599,919,395,1314,1240,861,2101,1072,1199,2271,342,794,1136,4280,3572,7852
2021-04-09,5,7,12,1,2,3,25,19,44,69,31,100,181,93,274,433,171,604,932,401,1333,1247,865,2112,1077,1201,2278,343,797,1140,4313,3587,7900
2021-04-10,5,7,12,1,2,3,25,19,44,69,32,101,181,93,274,440,171,611,939,405,1344,1253,870,2123,1078,1203,2281,344,799,1143,4335,3601,7936
2021-04-11,5,7,12,1,2,3,25,20,45,70,32,102,181,93,274,446,173,619,951,409,1360,1262,881,2143,1082,1208,2290,346,803,1149,4369,3628,7997
2021-04-12,5,7,12,1,2,3,25,21,46,70,33,103,182,93,275,450,176,626,956,414,1370,1272,891,2163,1083,1212,2295,346,804,1150,4390,3653,8043
2021-04-13,5,7,12,1,2,3,25,21,46,70,33,103,183,96,279,460,177,637,966,417,1383,1285,898,2183,1088,1218,2306,346,807,1153,4429,3676,8105
2021-04-14,6,7,13,1,2,3,25,21,46,71,34,105,186,96,282,469,179,648,980,425,1405,1303,903,2206,1090,1219,2309,348,810,1158,4479,3696,8175
2021-04-15,6,7,13,1,2,3,25,21,46,72,34,106,186,96,282,473,183,656,987,429,1416,1308,910,2218,1093,1225,2318,348,812,1160,4499,3719,8218
2021-04-16,6,7,13,1,2,3,25,21,46,72,34,106,187,97,284,475,184,659,995,434,1429,1322,913,2235,1098,1229,2327,350,814,1164,4531,3735,8266
2021-04-17,6,7,13,1,2,3,25,21,46,73,34,107,189,98,287,481,186,667,1006,440,1446,1335,926,2261,1100,1233,2333,351,815,1166,4567,3762,8329
2021-04-18,6,7,13,1,2,3,25,21,46,73,34,107,190,99,289,485,187,672,1014,444,1458,1342,933,2275,1106,1238,2344,352,819,1171,4594,3784,8378
2021-04-19,6,7,13,1,2,3,25,21,46,73,35,108,191,99,290,489,189,678,1021,452,1473,1354,936,2290,1109,1247,2356,352,821,1173,4621,3809,8430
2021-04-20,6,7,13,1,2,3,25,21,46,73,35,108,194,103,297,493,190,683,1029,456,1485,1363,939,2302,1117,1255,2372,354,823,1177,4655,3831,8486
2021-04-21,6,7,13,1,2,3,25,21,46,73,35,108,194,104,298,504,198,702,1038,463,1501,1379,945,2324,1125,1261,2386,355,827,1182,4700,3863,8563
2021-04-22,6,7,13,1,2,3,26,21,47,73,35,108,196,105,301,506,198,704,1046,468,1514,1389,955,2344,1133,1265,2398,357,830,1187,4733,3886,8619
2021-04-23,6,7,13,1,2,3,26,21,47,74,35,109,198,105,303,511,200,711,1054,475,1529,1392,958,2350,1138,1266,2404,358,836,1194,4758,3905,8663
2021-04-24,6,7,13,1,2,3,26,21,47,76,36,112,199,105,304,519,200,719,1063,479,1542,1399,960,2359,1140,1272,2412,358,836,1194,4787,3918,8705
2021-04-25,6,7,13,1,2,3,26,21,47,77,36,113,199,107,306,523,200,723,1070,485,1555,1406,965,2371,1145,1277,2422,359,836,1195,4812,3936,8748
2021-04-26,6,7,13,1,2,3,28,21,49,78,36,114,199,107,306,529,201,730,1078,492,1570,1412,976,2388,1147,1283,2430,361,838,1199,4839,3963,8802
2021-04-27,6,7,13,1,2,3,28,21,49,79,37,116,201,108,309,535,205,740,1089,496,1585,1423,982,2405,1154,1288,2442,363,839,1202,4879,3985,8864
2021-04-28,6,7,13,1,2,3,29,21,50,80,39,119,203,111,314,540,207,747,1103,503,1606,1429,988,2417,1154,1290,2444,364,840,1204,4909,4008,8917
2021-04-29,7,7,14,1,2,3,29,21,50,80,39,119,206,112,318,547,211,758,1113,513,1626,1432,999,2431,1157,1293,2450,364,840,1204,4936,4037,8973
2021-04-30,7,7,14,1,2,3,29,21,50,80,39,119,208,114,322,548,212,760,1119,521,1640,1440,1008,2448,1161,1294,2455,366,842,1208,4959,4060,9019
2021-05-01,7,7,14,1,2,3,29,22,51,83,39,122,208,114,322,549,214,763,1127,528,1655,1447,1011,2458,1162,1296,2458,366,844,1210,4979,4077,9056
2021-05-02,7,7,14,1,2,3,29,22,51,84,39,123,209,114,323,552,216,768,1133,529,1662,1452,1014,2466,1165,1299,2464,367,846,1213,4999,4088,9087
2021-05-03,7,7,14,1,2,3,29,22,51,85,41,126,210,114,324,558,217,775,1140,532,1672,1458,1022,2480,1169,1307,2476,371,847,1218,5028,4111,9139
2021-05-04,8,7,15,1,2,3,30,22,52,85,41,126,210,116,326,562,219,781,1153,538,1691,1466,1029,2495,1172,1313,2485,372,849,1221,5059,4136,9195
2021-05-05,8,7,15,1,2,3,30,22,52,85,42,127,213,118,331,568,223,791,1166,543,1709,1468,1034,2502,1177,1317,2494,375,851,1226,5091,4159,9250
2021-05-06,8,7,15,1,2,3,30,22,52,86,42,128,219,119,338,577,224,801,1174,547,1721,1472,1036,2508,1181,1320,2501,375,853,1228,5123,4172,9295
2021-05-07,8,7,15,1,2,3,30,22,52,86,42,128,220,120,340,581,225,806,1180,551,1731,1474,1040,2514,1188,1324,2512,375,855,1230,5143,4188,9331
2021-05-08,8,7,15,2,2,4,30,22,52,87,42,129,221,120,341,588,225,813,1186,555,1741,1478,1042,2520,1189,1328,2517,378,859,1237,5167,4202,9369
2021-05-09,8,7,15,2,2,4,30,22,52,87,42,129,222,121,343,588,225,813,1194,561,1755,1483,1044,2527,1191,1331,2522,378,862,1240,5183,4217,9400
2021-05-10,8,7,15,2,2,4,30,22,52,87,42,129,224,121,345,591,227,818,1206,566,1772,1494,1048,2542,1195,1342,2537,380,865,1245,5217,4242,9459
2021-05-11,8,7,15,2,2,4,30,22,52,89,42,131,227,121,348,593,230,823,1212,569,1781,1500,1057,2557,1200,1345,2545,382,867,1249,5243,4262,9505
2021-05-12,8,7,15,2,2,4,30,22,52,90,42,132,228,122,350,600,231,831,1222,572,1794,1503,1060,2563,1203,1346,2549,385,868,1253,5271,4272,9543
2021-05-13,8,7,15,2,2,4,31,24,55,91,42,133,230,122,352,607,234,841,1227,575,1802,1509,1063,2572,1204,1348,2552,386,869,1255,5295,4286,9581
2021-05-14,8,7,15,2,2,4,31,24,55,92,43,135,233,123,356,610,239,849,1229,579,1808,1516,1069,2585,1206,1353,2559,386,872,1258,5313,4311,9624
2021-05-15,8,7,15,2,2,4,31,24,55,92,43,135,235,124,359,613,241,854,1233,582,1815,1523,1076,2599,1209,1353,2562,386,873,1259,5332,4325,9657
2021-05-16,8,7,15,2,2,4,31,24,55,95,45,140,237,124,361,619,242,861,1239,586,1825,1530,1080,2610,1210,1357,2567,387,877,1264,5358,4344,9702
2021-05-17,8,7,15,2,2,4,32,24,56,95,46,141,240,126,366,622,250,872,1252,590,1842,1540,1087,2627,1217,1363,2580,390,878,1268,5398,4373,9771
2021-05-18,8,7,15,2,2,4,32,24,56,95,46,141,243,127,370,627,251,878,1259,593,1852,1547,1092,2639,1218,1368,2586,392,880,1272,5423,4390,9813
2021-05-19,8,7,15,3,2,5,32,24,56,95,46,141,246,128,374,633,252,885,1272,597,1869,1553,1097,2650,1223,1371,2594,394,882,1276,5459,4406,9865
2021-05-20,8,7,15,3,2,5,32,24,56,96,47,143,250,131,381,641,254,895,1281,600,1881,1564,1106,2670,1227,1375,2602,394,884,1278,5496,4430,9926
2021-05-21,9,7,16,3,2,5,32,24,56,97,47,144,252,131,383,648,255,903,1289,605,1894,1569,1111,2680,1229,1378,2607,396,885,1281,5524,4445,9969
2021-05-22,9,7,16,3,2,5,32,24,56,97,47,144,254,132,386,651,259,910,1299,610,1909,1575,1115,2690,1231,1384,2615,399,890,1289,5550,4470,10020
2021-05-23,9,7,16,3,3,6,32,24,56,98,47,145,254,132,386,658,261,919,1303,611,1914,1582,1120,2702,1238,1387,2625,401,892,1293,5578,4484,10062
2021-05-24,9,7,16,3,3,6,33,25,58,101,47,148,258,134,392,662,263,925,1311,612,1923,1592,1124,2716,1244,1390,2634,402,894,1296,5615,4499,10114
2021-05-25,9,7,16,3,3,6,33,25,58,104,47,151,263,135,398,664,264,928,1315,615,1930,1595,1125,2720,1250,1392,2642,402,895,1297,5638,4508,10146
2021-05-26,9,7,16,3,3,6,33,26,59,104,47,151,264,135,399,674,265,939,1324,621,1945,1604,1132,2736,1257,1403,2660,402,896,1298,5674,4535,10209
2021-05-27,9,7,16,3,3,6,33,26,59,106,48,154,265,135,400,680,267,947,1333,621,1954,1613,1136,2749,1261,1409,2670,403,900,1303,5706,4552,10258
2021-05-28,9,7,16,3,3,6,33,26,59,107,48,155,266,136,402,685,270,955,1338,623,1961,1616,1139,2755,1261,1415,2676,405,900,1305,5723,4567,10290
2021-05-29,9,7,16,3,3,6,33,26,59,107,48,155,267,136,403,692,270,962,1340,630,1970,1619,1141,2760,1263,1418,2681,405,900,1305,5738,4579,10317
2021-05-30,9,7,16,3,3,6,33,27,60,107,48,155,270,137,407,695,270,965,1343,634,1977,1623,1145,2768,1266,1421,2687,405,902,1307,5754,4594,10348
2021-05-31,9,7,16,3,3,6,33,27,60,108,48,156,271,139,410,703,275,978,1348,636,1984,1625,1147,2772,1273,1423,2696,406,904,1310,5779,4609,10388
2021-06-01,9,7,16,3,3,6,33,27,60,108,48,156,273,140,413,708,277,985,1354,637,1991,1629,1150,2779,1276,1427,2703,409,907,1316,5802,4623,10425
2021-06-02,9,7,16,3,3,6,33,27,60,108,48,156,273,140,413,711,282,993,1358,639,1997,1635,1154,2789,1281,1432,2713,412,910,1322,5823,4642,10465
2021-06-03,9,7,16,3,3,6,33,27,60,108,48,156,275,141,416,716,285,1001,1360,642,2002,1642,1160,2802,1285,1437,2722,415,910,1325,5846,4660,10506
2021-06-04,9,7,16,3,3,6,33,27,60,109,48,157,277,141,418,724,286,1010,1362,644,2006,1644,1161,2805,1290,1445,2735,415,911,1326,5866,4673,10539
2021-06-05,9,7,16,3,3,6,33,27,60,109,48,157,278,141,419,727,287,1014,1367,648,2015,1648,1163,2811,1295,1450,2745,417,913,1330,5886,4687,10573
2021-06-06,9,8,17,3,3,6,33,27,60,109,49,158,278,141,419,732,288,1020,1369,648,2017,1650,1164,2814,1296,1452,2748,419,915,1334,5898,4695,10593
2021-06-07,9,8,17,3,3,6,33,27,60,110,49,159,280,141,421,739,290,1029,1375,649,2024,1652,1167,2819,1304,1456,2760,421,918,1339,5926,4708,10634
2021-06-08,9,9,18,3,3,6,33,27,60,110,49,159,282,141,423,742,293,1035,1379,651,2030,1662,1168,2830,1309,1460,2769,423,918,1341,5952,4719,10671
2021-06-09,9,9,18,3,3,6,33,27,60,111,49,160,286,142,428,744,295,1039,1382,653,2035,1666,1170,2836,1315,1461,2776,423,919,1342,5972,4728,10700
2021-06-10,9,9,18,3,3,6,35,27,62,111,49,160,288,144,432,746,296,1042,1383,656,2039,1671,1174,2845,1320,1463,2783,426,921,1347,5992,4742,10734
2021-06-11,9,9,18,3,3,6,35,27,62,112,50,162,289,144,433,749,297,1046,1385,657,2042,1675,1178,2853,1322,1466,2788,429,923,1352,6008,4754,10762
2021-06-12,9,9,18,4,3,7,35,27,62,112,50,162,291,147,438,751,298,1049,1385,659,2044,1677,1179,2856,1323,1469,2792,429,925,1354,6016,4766,10782
2021-06-13,9,9,18,4,3,7,35,27,62,112,50,162,294,147,441,756,298,1054,1388,661,2049,1677,1181,2858,1328,1471,2799,429,927,1356,6032,4774,10806
2021-06-14,9,9,18,4,3,7,35,27,62,113,51,164,296,147,443,758,299,1057,1391,662,2053,1681,1183,2864,1331,1475,2806,430,929,1359,6048,4785,10833
2021-06-15,9,9,18,4,3,7,35,28,63,113,51,164,297,147,444,760,299,1059,1394,663,2057,1685,1185,2870,1333,1483,2816,430,932,1362,6060,4800,10860
2021-06-16,9,9,18,4,3,7,35,28,63,113,52,165,300,147,447,761,299,1060,1396,664,2060,1688,1189,2877,1334,1484,2818,431,935,1366,6071,4810,10881
2021-06-17,9,9,18,4,3,7,36,28,64,114,52,166,300,147,447,768,302,1070,1398,666,2064,1693,1191,2884,1336,1485,2821,431,935,1366,6089,4818,10907
2021-06-18,9,9,18,4,3,7,36,28,64,114,52,166,300,147,447,768,303,1071,1403,666,2069,1698,1192,2890,1337,1488,2825,432,936,1368,6101,4824,10925
2021-06-19,9,9,18,4,3,7,36,28,64,114,52,166,302,147,449,769,306,1075,1407,667,2074,1699,1198,2897,1338,1491,2829,433,937,1370,6111,4838,10949
2021-06-20,9,9,18,4,3,7,36,28,64,114,52,166,302,147,449,772,307,1079,1409,668,2077,1701,1199,2900,1339,1492,2831,433,939,1372,6119,4844,10963
2021-06-21,9,9,18,4,3,7,36,28,64,114,53,167,302,147,449,774,309,1083,1409,669,2078,1702,1201,2903,1340,1492,2832,433,941,1374,6123,4852,10975
2021-06-22,9,9,18,4,3,7,36,29,65,114,54,168,305,147,452,778,310,1088,1410,670,2080,1705,1204,2909,1342,1494,2836,433,942,1375,6136,4862,10998
2021-06-23,9,9,18,4,3,7,36,29,65,114,54,168,306,148,454,779,310,1089,1412,673,2085,1709,1207,2916,1345,1497,2842,433,943,1376,6147,4873,11020
2021-06-24,9,9,18,4,3,7,36,29,65,115,54,169,307,148,455,782,313,1095,1416,675,2091,1709,1210,2919,1346,1501,2847,435,943,1378,6159,4885,11044
2021-06-25,9,9,18,4,3,7,36,29,65,115,54,169,309,148,457,783,313,1096,1420,676,2096,1709,1211,2920,1347,1503,2850,435,945,1380,6167,4891,11058
2021-06-26,10,9,19,4,3,7,36,29,65,116,54,170,310,148,458,788,313,1101,1423,676,2099,1712,1213,2925,1350,1506,2856,435,947,1382,6184,4898,11082
2021-06-27,10,9,19,4,3,7,36,29,65,116,54,170,312,148,460,788,313,1101,1425,677,2102,1714,1216,2930,1351,1507,2858,435,948,1383,6191,4904,11095
2021-06-28,10,9,19,4,3,7,36,29,65,116,54,170,313,148,461,789,313,1102,1428,678,2106,1717,1219,2936,1352,1509,2861,435,948,1383,6200,4910,11110
2021-06-29,10,9,19,4,3,7,36,29,65,116,54,170,314,148,462,790,314,1104,1429,679,2108,1721,1223,2944,1354,1512,2866,436,950,1386,6210,4921,11131
2021-06-30,10,9,19,4,3,7,36,29,65,117,54,171,314,148,462,790,315,1105,1430,681,2111,1723,1226,2949,1355,1513,2868,437,950,1387,6216,4928,11144
2021-07-01,10,9,19,4,3,7,36,29,65,117,54,171,315,148,463,790,316,1106,1433,681,2114,1723,1227,2950,1357,1515,2872,437,951,1388,6222,4933,11155
2021-07-02,10,9,19,4,3,7,36,29,65,117,54,171,316,148,464,791,316,1107,1436,681,2117,1726,1229,2955,1358,1515,2873,437,953,1390,6231,4937,11168
2021-07-03,10,9,19,4,3,7,36,29,65,117,54,171,316,148,464,793,316,1109,1436,681,2117,1728,1231,2959,1360,1518,2878,437,954,1391,6237,4943,11180
2021-07-04,10,9,19,4,3,7,36,29,65,117,54,171,316,148,464,795,316,1111,1437,681,2118,1730,1231,2961,1360,1519,2879,437,955,1392,6242,4945,11187
2021-07-05,10,9,19,4,3,7,36,29,65,117,54,171,317,149,466,796,317,1113,1439,682,2121,1731,1232,2963,1361,1520,2881,439,955,1394,6250,4950,11200
2021-07-06,10,9,19,4,3,7,37,29,66,117,54,171,317,149,466,797,318,1115,1440,682,2122,1733,1235,2968,1365,1522,2887,440,955,1395,6260,4956,11216
2021-07-07,10,9,19,4,3,7,37,29,66,117,54,171,317,149,466,801,318,1119,1441,682,2123,1736,1237,2973,1367,1522,2889,441,955,1396,6271,4958,11229
2021-07-08,10,9,19,4,3,7,37,29,66,118,54,172,318,149,467,802,318,1120,1441,684,2125,1740,1238,2978,1368,1524,2892,441,956,1397,6279,4964,11243
2021-07-09,10,9,19,4,3,7,37,29,66,118,54,172,318,149,467,802,318,1120,1441,684,2125,1740,1238,2978,1370,1524,2894,441,956,1397,6281,4964,11245
2021-07-10,10,9,19,4,3,7,37,29,66,119,54,173,318,150,468,802,318,1120,1441,684,2125,1740,1240,2980,1372,1525,2897,442,958,1400,6285,4970,11255
2021-07-11,10,9,19,4,3,7,37,29,66,119,54,173,318,150,468,802,319,1121,1444,684,2128,1741,1241,2982,1373,1525,2898,442,958,1400,6290,4972,11262
2021-07-12,10,9,19,4,3,7,37,29,66,119,54,173,319,151,470,803,319,1122,1447,684,2131,1748,1241,2989,1373,1525,2898,442,960,1402,6302,4975,11277
2021-07-13,10,9,19,4,3,7,37,29,66,120,54,174,319,152,471,804,320,1124,1451,685,2136,1752,1242,2994,1375,1528,2903,443,960,1403,6315,4982,11297
2021-07-14,10,9,19,4,3,7,37,29,66,120,54,174,319,152,471,807,321,1128,1451,686,2137,1752,1244,2996,1375,1532,2907,443,960,1403,6318,4990,11308
2021-07-15,10,9,19,4,3,7,37,29,66,120,54,174,319,152,471,807,322,1129,1452,686,2138,1755,1245,3000,1376,1532,2908,444,961,1405,6324,4993,11317
2021-07-16,10,9,19,4,3,7,37,29,66,120,54,174,320,152,472,807,322,1129,1453,686,2139,1756,1245,3001,1376,1535,2911,444,961,1405,6327,4996,11323
2021-07-17,10,9,19,4,3,7,37,29,66,120,54,174,320,152,472,810,322,1132,1454,687,2141,1757,1247,3004,1376,1536,2912,445,961,1406,6333,5000,11333
2021-07-18,10,9,19,4,3,7,37,29,66,120,54,174,320,152,472,810,322,1132,1454,687,2141,1757,1248,3005,1379,1537,2916,445,961,1406,6336,5002,11338
2021-07-19,11,10,21,4,3,7,38,29,67,120,54,174,320,153,473,810,322,1132,1456,687,2143,1757,1249,3006,1381,1537,2918,446,961,1407,6343,5005,11348
2021-07-20,11,10,21,4,3,7,38,29,67,120,54,174,320,154,474,810,322,1132,1456,687,2143,1759,1250,3009,1382,1538,2920,446,961,1407,6346,5008,11354
2021-07-21,11,10,21,4,3,7,38,29,67,120,54,174,320,154,474,811,323,1134,1456,687,2143,1762,1254,3016,1382,1538,2920,446,961,1407,6350,5013,11363
2021-07-22,11,10,21,4,3,7,38,29,67,120,54,174,320,154,474,813,323,1136,1458,688,2146,1765,1254,3019,1382,1539,2921,446,961,1407,6357,5015,11372
2021-07-23,11,10,21,4,3,7,38,29,67,120,54,174,321,154,475,813,324,1137,1459,689,2148,1768,1256,3024,1383,1540,2923,446,962,1408,6363,5021,11384
2021-07-24,11,10,21,4,3,7,38,30,68,120,54,174,321,154,475,813,324,1137,1460,689,2149,1769,1256,3025,1383,1540,2923,446,962,1408,6365,5022,11387
2021-07-25,11,10,21,4,3,7,38,30,68,120,54,174,322,154,476,814,324,1138,1460,689,2149,1770,1257,3027,1383,1540,2923,446,963,1409,6368,5024,11392
2021-07-26,11,10,21,4,3,7,39,30,69,120,54,174,323,154,477,815,324,1139,1460,689,2149,1775,1259,3034,1384,1541,2925,446,964,1410,6377,5028,11405
2021-07-27,11,10,21,4,3,7,40,30,70,120,54,174,323,154,477,816,325,1141,1460,689,2149,1777,1259,3036,1384,1541,2925,447,965,1412,6382,5030,11412
2021-07-28,11,10,21,4,3,7,40,30,70,120,54,174,323,154,477,816,325,1141,1460,689,2149,1777,1259,3036,1385,1542,2927,447,965,1412,6383,5031,11414
2021-07-29,11,10,21,4,3,7,40,30,70,120,54,174,323,154,477,817,325,1142,1460,689,2149,1777,1260,3037,1386,1543,2929,447,965,1412,6385,5033,11418
2021-07-30,11,10,21,4,3,7,40,30,70,120,54,174,323,154,477,817,325,1142,1463,690,2153,1777,1261,3038,1386,1544,2930,447,966,1413,6388,5037,11425
2021-07-31,11,10,21,4,3,7,40,30,70,120,54,174,323,155,478,817,325,1142,1463,690,2153,1779,1261,3040,1386,1545,2931,447,966,1413,6390,5039,11429
2021-08-01,11,10,21,4,3,7,40,30,70,120,54,174,324,155,479,817,325,1142,1463,690,2153,1779,1261,3040,1387,1546,2933,447,966,1413,6392,5040,11432
2021-08-02,11,10,21,4,3,7,40,30,70,120,54,174,324,155,479,817,325,1142,1464,690,2154,1779,1264,3043,1387,1550,2937,447,966,1413,6393,5047,11440
2021-08-03,11,10,21,4,3,7,40,30,70,120,54,174,324,155,479,817,325,1142,1464,690,2154,1781,1264,3045,1388,1550,2938,447,968,1415,6396,5049,11445
2021-08-04,11,10,21,4,3,7,40,30,70,120,54,174,325,155,480,817,325,1142,1465,690,2155,1783,1264,3047,1388,1551,2939,448,969,1417,6401,5051,11452
2021-08-05,11,10,21,4,3,7,40,30,70,120,54,174,325,155,480,818,325,1143,1465,690,2155,1783,1266,3049,1388,1553,2941,448,970,1418,6402,5056,11458
2021-08-06,11,10,21,4,3,7,40,30,70,120,54,174,325,155,480,819,325,1144,1465,690,2155,1784,1266,3050,1388,1553,2941,448,970,1418,6404,5056,11460
2021-08-07,11,10,21,4,3,7,40,30,70,120,54,174,325,155,480,819,325,1144,1467,692,2159,1784,1266,3050,1388,1555,2943,448,970,1418,6406,5060,11466
2021-08-08,11,10,21,4,3,7,40,30,70,120,54,174,325,155,480,819,325,1144,1467,692,2159,1784,1268,3052,1388,1555,2943,448,970,1418,6406,5062,11468
2021-08-09,11,10,21,4,3,7,40,30,70,120,54,174,326,155,481,819,325,1144,1467,693,2160,1784,1270,3054,1389,1556,2945,448,970,1418,6408,5066,11474
2021-08-10,11,10,21,4,3,7,40,30,70,120,54,174,326,155,481,820,325,1145,1467,693,2160,1784,1271,3055,1389,1556,2945,448,970,1418,6409,5067,11476
2021-08-11,11,10,21,4,3,7,40,30,70,120,54,174,327,155,482,820,325,1145,1467,693,2160,1786,1272,3058,1389,1559,2948,448,971,1419,6412,5072,11484
2021-08-12,11,10,21,4,3,7,40,30,70,120,54,174,327,155,482,820,325,1145,1468,694,2162,1787,1273,3060,1390,1560,2950,448,971,1419,6415,5075,11490
2021-08-13,11,10,21,4,3,7,40,30,70,120,54,174,327,155,482,821,325,1146,1469,694,2163,1787,1274,3061,1391,1561,2952,448,971,1419,6418,5077,11495
2021-08-14,11,10,21,4,3,7,40,30,70,120,54,174,327,155,482,821,325,1146,1469,694,2163,1790,1275,3065,1391,1561,2952,448,971,1419,6421,5078,11499
2021-08-15,11,10,21,4,3,7,40,30,70,121,54,175,328,155,483,821,326,1147,1469,694,2163,1790,1275,3065,1391,1561,2952,449,971,1420,6424,5079,11503
2021-08-16,11,10,21,4,3,7,40,30,70,121,54,175,328,156,484,821,326,1147,1469,694,2163,1790,1275,3065,1392,1561,2953,449,971,1420,6425,5080,11505
2021-08-17,11,10,21,4,3,7,40,30,70,121,54,175,328,156,484,821,326,1147,1469,694,2163,1790,1276,3066,1393,1563,2956,449,972,1421,6426,5084,11510
2021-08-18,11,10,21,4,3,7,40,30,70,121,54,175,328,156,484,821,326,1147,1469,694,2163,1790,1277,3067,1394,1564,2958,449,972,1421,6427,5086,11513
2021-08-19,11,10,21,4,3,7,40,31,71,121,54,175,328,156,484,822,326,1148,1469,694,2163,1792,1277,3069,1395,1565,2960,449,972,1421,6431,5088,11519
2021-08-20,11,10,21,4,3,7,40,31,71,121,54,175,328,156,484,822,326,1148,1469,694,2163,1792,1278,3070,1396,1565,2961,449,972,1421,6432,5089,11521
2021-08-21,11,10,21,4,3,7,40,31,71,121,54,175,329,156,485,822,326,1148,1469,694,2163,1792,1278,3070,1397,1566,2963,449,972,1421,6434,5090,11524
2021-08-22,11,10,21,4,3,7,40,31,71,121,54,175,329,156,485,822,326,1148,1469,695,2164,1792,1279,3071,1398,1566,2964,449,973,1422,6435,5093,11528
2021-08-23,11,10,21,4,3,7,40,31,71,121,54,175,330,156,486,822,326,1148,1469,695,2164,1792,1279,3071,1399,1566,2965,450,973,1423,6438,5093,11531
2021-08-24,11,10,21,4,3,7,40,31,71,121,54,175,330,157,487,822,326,1148,1469,695,2164,1793,1280,3073,1400,1566,2966,450,973,1423,6440,5095,11535
2021-08-25,11,10,21,4,3,7,40,31,71,121,54,175,330,157,487,822,326,1148,1469,695,2164,1793,1280,3073,1400,1567,2967,450,973,1423,6440,5096,11536
2021-08-26,11,10,21,4,3,7,40,31,71,121,54,175,330,157,487,822,326,1148,1470,695,2165,1793,1280,3073,1400,1567,2967,450,974,1424,6441,5097,11538
2021-08-27,11,10,21,4,3,7,40,31,71,121,54,175,330,157,487,822,326,1148,1470,695,2165,1793,1281,3074,1400,1569,2969,450,974,1424,6441,5100,11541
2021-08-28,11,10,21,4,3,7,40,31,71,121,54,175,330,157,487,822,326,1148,1471,695,2166,1794,1281,3075,1400,1569,2969,450,974,1424,6443,5100,11543
2021-08-29,11,10,21,4,3,7,40,31,71,121,54,175,330,157,487,822,326,1148,1471,695,2166,1794,1283,3077,1400,1569,2969,450,974,1424,6443,5102,11545
2021-08-30,11,10,21,4,3,7,40,31,71,121,54,175,330,157,487,822,327,1149,1472,695,2167,1794,1283,3077,1400,1569,2969,451,974,1425,6445,5103,11548
2021-08-31,11,10,21,4,3,7,40,31,71,121,54,175,330,157,487,822,327,1149,1472,697,2169,1794,1283,3077,1401,1569,2970,451,976,1427,6446,5107,11553
2021-09-01,11,10,21,4,3,7,40,31,71,121,55,176,330,157,487,822,327,1149,1472,697,2169,1794,1283,3077,1401,1569,2970,451,977,1428,6446,5109,11555
2021-09-02,11,10,21,4,3,7,40,31,71,121,55,176,330,157,487,822,327,1149,1472,697,2169,1794,1283,3077,1401,1570,2971,451,977,1428,6446,5110,11556
2021-09-03,11,10,21,4,3,7,40,31,71,121,55,176,330,157,487,823,327,1150,1472,697,2169,1794,1283,3077,1402,1570,2972,451,977,1428,6448,5110,11558
2021-09-04,11,10,21,4,3,7,40,31,71,121,55,176,330,158,488,823,327,1150,1472,697,2169,1794,1283,3077,1402,1570,2972,451,977,1428,6448,5111,11559
2021-09-05,11,10,21,4,3,7,40,31,71,121,55,176,331,158,489,823,327,1150,1472,697,2169,1794,1283,3077,1402,1570,2972,451,977,1428,6449,5111,11560
2021-09-06,11,10,21,4,3,7,40,31,71,121,55,176,331,158,489,823,327,1150,1473,697,2170,1794,1283,3077,1402,1570,2972,451,977,1428,6450,5111,11561
2021-09-07,11,10,21,4,3,7,40,31,71,121,55,176,331,158,489,823,327,1150,1473,697,2170,1795,1283,3078,1402,1570,2972,451,977,1428,6451,5111,11562
2021-09-08,11,10,21,4,3,7,40,31,71,121,55,176,331,158,489,823,327,1150,1473,697,2170,1795,1284,3079,1402,1570,2972,451,978,1429,6451,5113,11564
2021-09-09,11,10,21,4,3,7,40,31,71,121,55,176,331,158,489,823,327,1150,1473,697,2170,1796,1284,3080,1403,1570,2973,451,978,1429,6453,5113,11566
2021-09-10,11,10,21,4,3,7,40,31,71,121,55,176,331,158,489,823,327,1150,1473,697,2170,1796,1284,3080,1403,1570,2973,451,978,1429,6453,5113,11566
2021-09-11,11,10,21,4,3,7,40,31,71,121,55,176,331,158,489,823,327,1150,1473,697,2170,1796,1284,3080,1403,1570,2973,451,978,1429,6453,5113,11566
2021-09-12,11,10,21,4,3,7,40,31,71,121,55,176,331,158,489,823,327,1150,1473,697,2170,1796,1284,3080,1403,1570,2973,451,978,1429,6453,5113,11566
2021-09-13,11,10,21,4,3,7,40,31,71,121,55,176,331,158,489,823,327,1150,1473,697,2170,1796,1284,3080,1403,1571,2974,451,978,1429,6453,5114,11567
2021-09-14,11,10,21,4,3,7,40,31,71,121,55,176,331,158,489,823,327,1150,1473,697,2170,1797,1284,3081,1403,1571,2974,451,978,1429,6454,5114,11568
2021-09-15,11,10,21,4,3,7,40,31,71,122,55,177,331,158,489,823,327,1150,1473,697,2170,1797,1284,3081,1403,1571,2974,451,978,1429,6455,5114,11569
2021-09-16,11,10,21,4,3,7,40,31,71,122,55,177,331,158,489,823,327,1150,1473,697,2170,1797,1285,3082,1403,1571,2974,451,978,1429,6455,5115,11570
2021-09-17,11,10,21,4,3,7,40,31,71,122,55,177,331,158,489,823,327,1150,1473,697,2170,1797,1285,3082,1403,1571,2974,451,978,1429,6455,5115,11570
2021-09-18,11,10,21,4,3,7,40,31,71,122,55,177,331,158,489,823,327,1150,1473,697,2170,1797,1285,3082,1403,1571,2974,451,978,1429,6455,5115,11570
2021-09-19,11,10,21,4,3,7,40,31,71,122,55,177,331,158,489,823,327,1150,1473,697,2170,1797,1286,3083,1403,1571,2974,451,978,1429,6455,5116,11571
2021-09-20,11,10,21,4,3,7,40,31,71,122,55,177,331,158,489,823,327,1150,1473,697,2170,1797,1286,3083,1403,1571,2974,451,978,1429,6455,5116,11571
2021-09-21,11,10,21,4,3,7,40,31,71,122,55,177,331,158,489,823,327,1150,1473,697,2170,1797,1286,3083,1403,1571,2974,451,978,1429,6455,5116,11571
2021-09-22,11,10,21,4,3,7,40,31,71,122,55,177,331,158,489,823,327,1150,1473,697,2170,1797,1286,3083,1403,1571,2974,451,978,1429,6455,5116,11571
2021-09-23,11,10,21,4,3,7,40,31,71,122,55,177,331,158,489,823,327,1150,1474,697,2171,1797,1286,3083,1403,1571,2974,451,978,1429,6456,5116,11572
2021-09-24,11,10,21,4,3,7,40,31,71,122,55,177,331,158,489,823,327,1150,1474,697,2171,1797,1286,3083,1404,1571,2975,451,978,1429,6457,5116,11573
2021-09-25,11,10,21,4,3,7,40,31,71,122,55,177,331,158,489,823,327,1150,1474,697,2171,1798,1286,3084,1404,1571,2975,451,978,1429,6458,5116,11574
2021-09-26,11,10,21,4,3,7,40,31,71,122,55,177,331,158,489,823,327,1150,1474,697,2171,1798,1286,3084,1404,1571,2975,451,978,1429,6458,5116,11574
2021-09-27,11,10,21,4,3,7,40,31,71,122,55,177,331,158,489,823,327,1150,1474,697,2171,1798,1286,3084,1404,1571,2975,451,978,1429,6458,5116,11574
2021-09-28,11,10,21,4,3,7,40,31,71,122,55,177,331,158,489,823,327,1150,1474,697,2171,1798,1286,3084,1404,1571,2975,451,978,1429,6458,5116,11574
2021-09-29,11,10,21,4,3,7,40,31,71,122,55,177,331,158,489,823,327,1150,1474,697,2171,1798,1286,3084,1404,1571,2975,451,978,1429,6458,5116,11574
2021-09-30,11,10,21,4,3,7,40,31,71,122,55,177,331,158,489,824,327,1151,1474,697,2171,1798,1286,3084,1404,1571,2975,451,978,1429,6459,5116,11575
2021-10-01,11,10,21,4,3,7,40,31,71,122,55,177,331,158,489,824,327,1151,1474,697,2171,1798,1287,3085,1404,1571,2975,451,978,1429,6459,5117,11576
2021-10-02,11,10,21,4,3,7,40,31,71,122,55,177,331,158,489,824,327,1151,1474,697,2171,1798,1287,3085,1404,1571,2975,451,978,1429,6459,5117,11576
2021-10-03,11,10,21,4,3,7,40,31,71,122,55,177,331,158,489,824,327,1151,1475,697,2172,1798,1287,3085,1404,1571,2975,451,978,1429,6460,5117,11577
2021-10-04,11,10,21,4,3,7,40,31,71,122,56,178,331,158,489,824,327,1151,1475,697,2172,1798,1287,3085,1404,1571,2975,451,978,1429,6460,5118,11578
2021-10-05,11,10,21,4,3,7,40,31,71,122,56,178,331,158,489,824,328,1152,1475,697,2172,1798,1287,3085,1404,1571,2975,451,978,1429,6460,5119,11579
2021-10-06,11,10,21,4,3,7,40,31,71,122,56,178,331,158,489,824,328,1152,1475,697,2172,1798,1288,3086,1404,1571,2975,451,978,1429,6460,5120,11580
2021-10-07,11,10,21,4,3,7,40,31,71,122,56,178,331,158,489,824,328,1152,1475,697,2172,1798,1288,3086,1404,1571,2975,451,978,1429,6460,5120,11580
2021-10-08,11,10,21,4,3,7,40,31,71,122,56,178,331,158,489,824,328,1152,1475,697,2172,1798,1288,3086,1405,1571,2976,451,978,1429,6461,5120,11581
2021-10-09,11,10,21,4,3,7,40,31,71,122,56,178,331,158,489,824,328,1152,1475,697,2172,1798,1288,3086,1405,1571,2976,451,978,1429,6461,5120,11581
2021-10-10,11,10,21,4,3,7,40,31,71,122,56,178,331,158,489,824,328,1152,1475,697,2172,1798,1288,3086,1405,1571,2976,451,978,1429,6461,5120,11581
2021-10-11,11,10,21,4,3,7,40,31,71,122,56,178,331,158,489,824,328,1152,1475,697,2172,1798,1288,3086,1405,1571,2976,451,978,1429,6461,5120,11581
2021-10-12,11,10,21,4,3,7,40,31,71,122,56,178,331,158,489,824,328,1152,1475,697,2172,1798,1289,3087,1405,1571,2976,451,978,1429,6461,5121,11582
2021-10-13,11,10,21,4,3,7,40,31,71,122,56,178,331,158,489,824,328,1152,1475,697,2172,1798,1290,3088,1405,1571,2976,451,978,1429,6461,5122,11583
2021-10-14,11,10,21,4,3,7,40,31,71,122,56,178,331,158,489,825,328,1153,1476,697,2173,1798,1290,3088,1405,1571,2976,451,978,1429,6463,5122,11585
2021-10-15,11,10,21,4,3,7,40,31,71,122,56,178,331,158,489,825,328,1153,1476,697,2173,1800,1290,3090,1405,1571,2976,451,978,1429,6465,5122,11587
2021-10-16,11,10,21,4,3,7,40,31,71,122,56,178,331,158,489,825,328,1153,1476,697,2173,1800,1290,3090,1407,1571,2978,451,978,1429,6467,5122,11589
2021-10-17,11,10,21,4,3,7,40,31,71,122,56,178,332,158,490,825,328,1153,1476,697,2173,1800,1290,3090,1407,1571,2978,451,978,1429,6468,5122,11590
2021-10-18,11,10,21,4,3,7,40,31,71,122,56,178,332,158,490,825,328,1153,1476,697,2173,1800,1290,3090,1407,1571,2978,451,978,1429,6468,5122,11590
2021-10-19,11,10,21,4,3,7,40,31,71,122,56,178,332,158,490,826,328,1154,1476,697,2173,1800,1290,3090,1407,1571,2978,452,978,1430,6470,5122,11592
2021-10-20,11,10,21,4,3,7,40,31,71,122,56,178,332,158,490,826,328,1154,1476,697,2173,1800,1290,3090,1407,1571,2978,452,978,1430,6470,5122,11592
2021-10-21,11,10,21,4,3,7,40,31,71,122,56,178,332,158,490,826,328,1154,1476,697,2173,1800,1290,3090,1407,1571,2978,452,978,1430,6470,5122,11592
2021-10-22,11,10,21,4,3,7,40,31,71,122,56,178,332,158,490,826,328,1154,1476,697,2173,1800,1290,3090,1407,1571,2978,453,978,1431,6471,5122,11593
2021-10-23,11,10,21,4,3,7,40,31,71,122,56,178,332,158,490,827,328,1155,1476,697,2173,1800,1290,3090,1407,1571,2978,453,978,1431,6472,5122,11594
2021-10-24,11,10,21,4,3,7,40,31,71,122,56,178,332,158,490,827,328,1155,1476,697,2173,1800,1290,3090,1407,1571,2978,453,978,1431,6472,5122,11594
2021-10-25,11,10,21,4,3,7,40,31,71,122,56,178,332,158,490,828,329,1157,1476,697,2173,1800,1290,3090,1407,1572,2979,453,978,1431,6473,5124,11597
2021-10-26,11,10,21,4,3,7,40,31,71,122,56,178,332,158,490,828,329,1157,1476,698,2174,1800,1290,3090,1407,1572,2979,453,978,1431,6473,5125,11598
2021-10-27,11,10,21,4,3,7,40,31,71,122,56,178,332,158,490,828,329,1157,1476,698,2174,1800,1291,3091,1407,1572,2979,453,978,1431,6473,5126,11599
2021-10-28,11,10,21,4,3,7,40,31,71,122,56,178,332,158,490,828,329,1157,1476,698,2174,1800,1291,3091,1407,1573,2980,453,978,1431,6473,5127,11600
2021-10-29,11,10,21,4,3,7,40,31,71,122,56,178,332,158,490,828,329,1157,1476,698,2174,1800,1291,3091,1407,1573,2980,453,978,1431,6473,5127,11600
2021-10-30,11,10,21,4,3,7,40,31,71,122,56,178,332,158,490,828,329,1157,1476,698,2174,1800,1292,3092,1407,1573,2980,453,978,1431,6473,5128,11601
2021-10-31,11,10,21,4,3,7,40,31,71,122,56,178,332,158,490,828,329,1157,1476,698,2174,1800,1292,3092,1407,1573,2980,453,979,1432,6473,5129,11602
2021-11-01,11,10,21,4,3,7,40,31,71,122,56,178,332,158,490,828,329,1157,1476,698,2174,1800,1292,3092,1407,1573,2980,453,979,1432,6473,5129,11602
2021-11-02,11,10,21,4,3,7,40,31,71,122,56,178,332,158,490,828,329,1157,1476,698,2174,1800,1292,3092,1407,1573,2980,453,979,1432,6473,5129,11602
2021-11-03,11,10,21,4,3,7,40,31,71,122,56,178,332,158,490,828,329,1157,1476,698,2174,1800,1292,3092,1407,1573,2980,453,979,1432,6473,5129,11602
2021-11-04,11,10,21,4,3,7,40,31,71,122,56,178,332,158,490,828,329,1157,1476,698,2174,1800,1292,3092,1407,1573,2980,453,979,1432,6473,5129,11602
2021-11-05,11,10,21,4,3,7,40,31,71,122,56,178,332,158,490,828,329,1157,1476,698,2174,1800,1292,3092,1407,1573,2980,453,979,1432,6473,5129,11602
2021-11-06,11,10,21,4,3,7,40,31,71,122,56,178,332,158,490,829,329,1158,1476,698,2174,1800,1292,3092,1407,1573,2980,453,979,1432,6474,5129,11603
2021-11-07,11,10,21,4,3,7,40,31,71,122,56,178,332,158,490,829,329,1158,1476,698,2174,1800,1292,3092,1407,1573,2980,453,979,1432,6474,5129,11603
2021-11-08,11,10,21,4,3,7,40,31,71,122,56,178,332,158,490,829,329,1158,1476,698,2174,1800,1292,3092,1407,1574,2981,453,979,1432,6474,5130,11604
2021-11-09,11,10,21,4,3,7,40,31,71,122,57,179,332,158,490,829,329,1158,1476,698,2174,1800,1292,3092,1407,1574,2981,453,979,1432,6474,5131,11605
2021-11-10,11,10,21,4,3,7,40,31,71,122,57,179,332,158,490,829,329,1158,1476,698,2174,1800,1292,3092,1407,1574,2981,453,979,1432,6474,5131,11605
2021-11-11,11,10,21,4,3,7,40,32,72,122,57,179,333,158,491,829,329,1158,1476,698,2174,1800,1292,3092,1407,1574,2981,453,979,1432,6475,5132,11607
2021-11-12,11,10,21,4,3,7,40,32,72,122,57,179,333,158,491,829,329,1158,1476,698,2174,1800,1292,3092,1407,1574,2981,453,979,1432,6475,5132,11607
2021-11-13,11,10,21,4,3,7,40,32,72,122,57,179,333,158,491,829,329,1158,1476,698,2174,1800,1292,3092,1407,1574,2981,453,979,1432,6475,5132,11607
2021-11-14,11,10,21,4,3,7,40,32,72,122,57,179,333,158,491,829,329,1158,1476,698,2174,1800,1292,3092,1408,1574,2982,453,979,1432,6476,5132,11608
2021-11-15,11,10,21,4,3,7,40,32,72,122,57,179,333,158,491,829,329,1158,1477,698,2175,1800,1292,3092,1409,1574,2983,453,979,1432,6478,5132,11610
2021-11-16,11,10,21,4,3,7,40,32,72,122,57,179,333,158,491,829,329,1158,1477,698,2175,1800,1292,3092,1410,1574,2984,453,980,1433,6479,5133,11612
2021-11-17,11,10,21,4,3,7,40,32,72,122,57,179,333,158,491,829,329,1158,1477,698,2175,1800,1292,3092,1411,1574,2985,453,980,1433,6480,5133,11613
2021-11-18,11,10,21,4,3,7,40,32,72,122,57,179,333,158,491,829,329,1158,1477,698,2175,1800,1292,3092,1411,1574,2985,453,980,1433,6480,5133,11613
2021-11-19,11,10,21,4,3,7,40,32,72,122,57,179,333,158,491,829,329,1158,1477,698,2175,1800,1292,3092,1411,1574,2985,453,980,1433,6480,5133,11613
2021-11-20,11,10,21,4,3,7,40,32,72,122,57,179,333,158,491,829,329,1158,1477,698,2175,1800,1292,3092,1411,1574,2985,453,981,1434,6480,5134,11614
2021-11-21,11,10,21,4,3,7,40,32,72,122,57,179,333,158,491,829,329,1158,1477,698,2175,1800,1292,3092,1411,1574,2985,453,981,1434,6480,5134,11614
2021-11-22,11,10,21,4,3,7,40,32,72,122,57,179,333,158,491,829,329,1158,1477,698,2175,1800,1293,3093,1411,1574,2985,453,981,1434,6480,5135,11615
2021-11-23,11,10,21,4,3,7,40,32,72,122,57,179,333,158,491,829,329,1158,1477,698,2175,1800,1293,3093,1411,1574,2985,453,981,1434,6480,5135,11615
2021-11-24,11,10,21,4,3,7,40,32,72,122,57,179,333,158,491,829,329,1158,1478,698,2176,1800,1293,3093,1412,1574,2986,453,982,1435,6482,5136,11618
2021-11-25,11,10,21,4,3,7,40,32,72,122,57,179,333,158,491,829,329,1158,1478,698,2176,1800,1293,3093,1412,1575,2987,453,982,1435,6482,5137,11619
2021-11-26,11,10,21,4,3,7,40,32,72,122,57,179,333,158,491,829,329,1158,1478,698,2176,1800,1293,3093,1412,1575,2987,453,982,1435,6482,5137,11619
2021-11-27,11,10,21,4,3,7,40,32,72,122,57,179,333,158,491,829,329,1158,1478,698,2176,1800,1293,3093,1412,1575,2987,453,982,1435,6482,5137,11619
2021-11-28,11,10,21,4,3,7,40,32,72,122,57,179,333,158,491,829,329,1158,1478,698,2176,1800,1293,3093,1412,1575,2987,453,982,1435,6482,5137,11619
2021-11-29,11,10,21,4,3,7,40,32,72,122,57,179,333,158,491,829,329,1158,1478,698,2176,1800,1293,3093,1412,1575,2987,453,982,1435,6482,5137,11619
2021-11-30,11,10,21,4,3,7,40,32,72,122,57,179,333,158,491,829,329,1158,1479,698,2177,1800,1293,3093,1412,1575,2987,453,982,1435,6483,5137,11620
2021-12-01,11,10,21,4,3,7,40,32,72,122,57,179,333,158,491,829,329,1158,1479,698,2177,1800,1294,3094,1412,1575,2987,453,983,1436,6483,5139,11622
2021-12-02,11,10,21,4,3,7,40,32,72,122,57,179,333,158,491,829,329,1158,1479,698,2177,1800,1294,3094,1413,1575,2988,453,984,1437,6484,5140,11624
2021-12-03,11,10,21,4,3,7,40,32,72,122,57,179,333,158,491,829,329,1158,1479,698,2177,1801,1294,3095,1413,1575,2988,453,984,1437,6485,5140,11625
2021-12-04,11,10,21,4,3,7,40,32,72,122,57,179,333,158,491,829,329,1158,1479,698,2177,1802,1294,3096,1413,1576,2989,453,984,1437,6486,5141,11627
2021-12-05,11,10,21,4,3,7,40,32,72,122,57,179,333,158,491,830,329,1159,1479,698,2177,1802,1295,3097,1413,1576,2989,453,984,1437,6487,5142,11629
2021-12-06,11,10,21,4,3,7,40,32,72,122,57,179,333,158,491,830,329,1159,1479,698,2177,1802,1295,3097,1413,1576,2989,454,984,1438,6488,5142,11630
2021-12-07,11,10,21,4,3,7,40,32,72,122,57,179,333,158,491,830,329,1159,1479,698,2177,1802,1295,3097,1413,1578,2991,454,984,1438,6488,5144,11632
2021-12-08,11,10,21,4,3,7,40,32,72,123,57,180,333,158,491,830,329,1159,1480,698,2178,1802,1296,3098,1413,1578,2991,454,984,1438,6490,5145,11635
2021-12-09,11,10,21,4,3,7,40,32,72,123,57,180,333,158,491,830,329,1159,1480,698,2178,1802,1297,3099,1415,1578,2993,454,984,1438,6492,5146,11638
2021-12-10,11,10,21,4,3,7,40,32,72,123,57,180,333,158,491,830,330,1160,1480,698,2178,1802,1297,3099,1415,1579,2994,454,984,1438,6492,5148,11640
2021-12-11,11,10,21,4,3,7,40,32,72,123,57,180,333,158,491,830,330,1160,1480,698,2178,1802,1297,3099,1415,1579,2994,454,984,1438,6492,5148,11640
2021-12-12,11,10,21,4,3,7,40,32,72,123,57,180,333,158,491,830,330,1160,1480,698,2178,1802,1297,3099,1415,1579,2994,454,984,1438,6492,5148,11640
2021-12-13,11,10,21,4,3,7,40,32,72,123,57,180,333,158,491,830,330,1160,1481,698,2179,1803,1297,3100,1415,1580,2995,454,984,1438,6494,5149,11643
2021-12-14,11,10,21,4,3,7,40,32,72,123,57,180,333,158,491,830,330,1160,1481,698,2179,1803,1297,3100,1415,1580,2995,454,984,1438,6494,5149,11643
2021-12-15,11,10,21,4,3,7,41,32,73,123,57,180,333,158,491,830,330,1160,1481,698,2179,1803,1297,3100,1415,1581,2996,454,984,1438,6495,5150,11645
2021-12-16,11,10,21,4,3,7,41,32,73,123,57,180,333,158,491,830,330,1160,1481,698,2179,1803,1298,3101,1416,1581,2997,454,984,1438,6496,5151,11647
2021-12-17,11,10,21,4,3,7,41,32,73,123,57,180,333,158,491,830,330,1160,1481,698,2179,1804,1298,3102,1417,1581,2998,454,984,1438,6498,5151,11649
2021-12-18,11,10,21,4,3,7,41,32,73,123,57,180,333,158,491,830,330,1160,1481,698,2179,1804,1298,3102,1418,1581,2999,454,985,1439,6499,5152,11651
2021-12-19,11,10,21,4,3,7,41,32,73,123,57,180,333,158,491,830,330,1160,1481,698,2179,1804,1298,3102,1418,1581,2999,454,985,1439,6499,5152,11651
2021-12-20,11,10,21,4,3,7,41,32,73,123,58,181,333,158,491,830,330,1160,1481,698,2179,1805,1298,3103,1421,1581,3002,454,985,1439,6503,5153,11656
2021-12-21,11,10,21,4,3,7,41,32,73,123,58,181,333,158,491,830,330,1160,1481,698,2179,1806,1298,3104,1422,1581,3003,454,987,1441,6505,5155,11660
2021-12-22,11,10,21,4,3,7,41,32,73,123,58,181,333,158,491,830,330,1160,1482,698,2180,1806,1298,3104,1422,1581,3003,454,987,1441,6506,5155,11661
2021-12-23,11,10,21,4,3,7,41,32,73,123,58,181,333,158,491,831,330,1161,1482,698,2180,1808,1298,3106,1422,1581,3003,454,987,1441,6509,5155,11664
2021-12-24,11,10,21,4,3,7,41,32,73,123,58,181,333,158,491,833,330,1163,1483,698,2181,1808,1298,3106,1423,1581,3004,454,988,1442,6513,5156,11669
2021-12-25,11,10,21,4,3,7,41,32,73,123,58,181,333,158,491,833,330,1163,1483,698,2181,1808,1298,3106,1423,1581,3004,454,989,1443,6513,5157,11670
2021-12-26,11,10,21,4,3,7,41,32,73,123,58,181,333,158,491,834,330,1164,1483,698,2181,1808,1298,3106,1424,1583,3007,454,989,1443,6515,5159,11674
2021-12-27,11,10,21,4,3,7,41,32,73,124,58,182,333,158,491,834,331,1165,1483,699,2182,1810,1299,3109,1424,1584,3008,454,989,1443,6518,5163,11681
2021-12-28,11,10,21,4,3,7,41,32,73,124,58,182,333,158,491,834,332,1166,1483,699,2182,1811,1301,3112,1425,1588,3013,454,990,1444,6520,5171,11691
2021-12-29,11,10,21,4,3,7,41,32,73,124,58,182,333,158,491,835,332,1167,1483,700,2183,1811,1305,3116,1425,1591,3016,454,990,1444,6521,5179,11700
2021-12-30,11,10,21,4,3,7,41,33,74,124,58,182,333,158,491,837,333,1170,1484,701,2185,1813,1306,3119,1425,1593,3018,456,990,1446,6528,5185,11713
2021-12-31,11,10,21,4,3,7,41,33,74,124,58,182,333,158,491,838,333,1171,1485,701,2186,1814,1306,3120,1427,1594,3021,456,991,1447,6533,5187,11720
2022-01-01,11,10,21,4,3,7,41,33,74,124,58,182,334,158,492,839,333,1172,1486,701,2187,1814,1308,3122,1429,1594,3023,456,992,1448,6538,5190,11728
2022-01-02,11,10,21,4,3,7,41,33,74,125,58,183,334,158,492,842,333,1175,1487,701,2188,1817,1312,3129,1430,1594,3024,456,993,1449,6547,5195,11742
2022-01-03,11,10,21,4,4,8,41,34,75,125,58,183,335,160,495,843,333,1176,1487,702,2189,1820,1315,3135,1434,1598,3032,457,994,1451,6557,5208,11765
2022-01-04,11,10,21,4,4,8,41,34,75,125,58,183,335,160,495,844,333,1177,1489,702,2191,1827,1317,3144,1438,1602,3040,458,997,1455,6572,5217,11789
2022-01-05,11,10,21,4,4,8,42,34,76,125,58,183,335,160,495,844,334,1178,1491,704,2195,1828,1317,3145,1441,1604,3045,458,997,1455,6579,5222,11801
2022-01-06,11,10,21,4,4,8,42,34,76,125,58,183,336,160,496,848,334,1182,1492,706,2198,1828,1323,3151,1444,1608,3052,459,998,1457,6589,5235,11824
2022-01-07,11,10,21,4,4,8,42,34,76,125,58,183,336,161,497,848,334,1182,1492,706,2198,1830,1325,3155,1447,1610,3057,460,999,1459,6595,5241,11836
2022-01-08,11,10,21,4,4,8,42,34,76,125,58,183,336,161,497,848,335,1183,1492,706,2198,1831,1329,3160,1447,1611,3058,462,1001,1463,6598,5249,11847
2022-01-09,11,10,21,4,4,8,42,34,76,125,58,183,336,161,497,851,336,1187,1494,706,2200,1833,1330,3163,1455,1612,3067,463,1003,1466,6614,5254,11868
2022-01-10,11,10,21,4,4,8,42,34,76,125,58,183,338,161,499,851,337,1188,1497,707,2204,1839,1333,3172,1460,1620,3080,463,1009,1472,6630,5273,11903
2022-01-11,11,10,21,4,4,8,42,34,76,125,58,183,338,161,499,851,338,1189,1498,710,2208,1844,1338,3182,1462,1625,3087,464,1013,1477,6639,5291,11930
2022-01-12,11,10,21,4,4,8,42,34,76,126,58,184,339,161,500,851,338,1189,1500,710,2210,1846,1342,3188,1466,1630,3096,466,1017,1483,6651,5304,11955
2022-01-13,11,10,21,4,4,8,42,34,76,126,58,184,339,162,501,851,339,1190,1502,710,2212,1847,1342,3189,1468,1635,3103,468,1023,1491,6658,5317,11975
2022-01-14,11,10,21,4,4,8,42,34,76,126,58,184,339,162,501,852,340,1192,1503,712,2215,1848,1346,3194,1481,1642,3123,469,1028,1497,6675,5336,12011
2022-01-15,11,10,21,4,4,8,42,34,76,126,58,184,339,162,501,852,341,1193,1504,714,2218,1851,1348,3199,1490,1651,3141,470,1031,1501,6689,5353,12042
2022-01-16,12,11,23,4,4,8,42,34,76,127,58,185,340,163,503,852,342,1194,1505,714,2219,1856,1351,3207,1495,1651,3146,472,1035,1507,6705,5363,12068
2022-01-17,14,11,25,4,4,8,42,34,76,127,58,185,340,163,503,852,342,1194,1505,717,2222,1857,1361,3218,1501,1657,3158,477,1040,1517,6719,5387,12106
2022-01-18,14,11,25,4,4,8,42,34,76,127,58,185,341,163,504,853,343,1196,1505,717,2222,1860,1365,3225,1505,1659,3164,477,1041,1518,6728,5395,12123
2022-01-19,14,11,25,4,4,8,42,34,76,127,58,185,341,163,504,854,343,1197,1507,719,2226,1868,1368,3236,1511,1660,3171,479,1043,1522,6747,5403,12150
2022-01-20,14,11,25,4,4,8,42,34,76,127,58,185,341,163,504,855,344,1199,1508,720,2228,1869,1370,3239,1518,1663,3181,481,1048,1529,6759,5415,12174
2022-01-21,14,11,25,4,4,8,42,35,77,127,58,185,341,163,504,855,345,1200,1509,720,2229,1870,1370,3240,1518,1667,3185,482,1048,1530,6762,5421,12183
2022-01-22,14,11,25,4,4,8,42,35,77,127,58,185,341,163,504,855,345,1200,1509,720,2229,1871,1371,3242,1518,1670,3188,484,1049,1533,6765,5426,12191
2022-01-23,14,11,25,4,4,8,42,35,77,127,58,185,341,163,504,856,345,1201,1509,721,2230,1871,1372,3243,1518,1672,3190,484,1050,1534,6766,5431,12197
2022-01-24,14,11,25,4,4,8,42,35,77,127,58,185,341,164,505,857,345,1202,1509,723,2232,1874,1372,3246,1519,1673,3192,484,1052,1536,6771,5437,12208
2022-01-25,14,11,25,4,4,8,42,35,77,127,58,185,341,164,505,857,345,1202,1511,724,2235,1874,1373,3247,1521,1678,3199,485,1055,1540,6776,5447,12223
2022-01-26,14,11,25,4,4,8,42,35,77,127,58,185,341,164,505,857,347,1204,1512,724,2236,1874,1373,3247,1521,1680,3201,486,1055,1541,6778,5451,12229
2022-01-27,14,11,25,4,4,8,42,35,77,127,58,185,341,164,505,857,347,1204,1512,725,2237,1874,1375,3249,1522,1680,3202,487,1056,1543,6780,5455,12235
2022-01-28,14,11,25,4,4,8,42,35,77,127,58,185,341,164,505,857,347,1204,1512,725,2237,1875,1375,3250,1526,1681,3207,487,1057,1544,6785,5457,12242
2022-01-29,14,11,25,4,4,8,42,35,77,127,58,185,342,164,506,857,347,1204,1512,725,2237,1875,1375,3250,1526,1681,3207,487,1057,1544,6786,5457,12243
2022-01-30,14,11,25,4,4,8,42,35,77,127,58,185,342,165,507,858,347,1205,1513,725,2238,1877,1376,3253,1526,1681,3207,488,1057,1545,6791,5459,12250
2022-01-31,14,11,25,4,4,8,42,35,77,127,58,185,342,165,507,858,347,1205,1513,725,2238,1877,1377,3254,1526,1681,3207,488,1057,1545,6791,5460,12251
2022-02-01,14,11,25,4,5,9,42,35,77,127,58,185,342,165,507,858,347,1205,1513,725,2238,1877,1377,3254,1526,1681,3207,488,1057,1545,6791,5461,12252
2022-02-02,14,11,25,4,5,9,42,35,77,127,58,185,342,165,507,858,347,1205,1513,725,2238,1877,1377,3254,1526,1682,3208,488,1057,1545,6791,5462,12253
2022-02-03,14,11,25,4,5,9,42,35,77,127,58,185,342,165,507,858,347,1205,1513,725,2238,1877,1377,3254,1526,1682,3208,488,1057,1545,6791,5462,12253
