FECHA,<=10M,<=10F,<=10,11-20M,11-20F,11-20,21-30M,21-30F,21-30,31-40M,31-40F,31-40,41-50M,41-50F,41-50,51-60M,51-60F,51-60,61-70M,61-70F,61-70,71-80M,71-80F,71-80,81-90M,81-90F,81-90,>=91M,>=91F,>=91,TotalM,TotalF,Total
2020-03-15,0,0,0,0,0,0,0,0,0,0,0,0,0,0,0,0,0,0,0,0,0,0,0,0,0,0,0,0,0,0,0,0,0
2020-03-16,0,0,0,0,0,0,0,0,0,0,0,0,0,0,0,0,0,0,0,0,0,0,0,0,0,0,0,0,0,0,0,0,0
2020-03-17,0,0,0,0,0,0,0,0,0,0,0,0,0,0,0,0,0,0,0,0,0,1,0,1,0,0,0,0,0,0,1,0,1
2020-03-18,0,0,0,0,0,0,0,0,0,0,0,0,0,0,0,0,0,0,0,0,0,1,0,1,0,0,0,0,0,0,1,0,1
2020-03-19,0,0,0,0,0,0,0,0,0,0,0,0,0,0,0,0,0,0,0,0,0,1,0,1,0,0,0,0,0,0,1,0,1
2020-03-20,0,0,0,0,0,0,0,0,0,0,0,0,0,0,0,0,0,0,0,0,0,1,0,1,0,1,1,0,0,0,1,1,2
2020-03-21,0,0,0,0,0,0,0,0,0,0,0,0,0,0,0,0,0,0,1,0,1,3,0,3,0,1,1,0,0,0,4,1,5
2020-03-22,0,0,0,0,0,0,0,0,0,0,0,0,0,0,0,0,0,0,1,0,1,4,0,4,0,1,1,0,0,0,5,1,6
2020-03-23,0,0,0,0,0,0,0,0,0,0,0,0,0,0,0,0,0,0,1,0,1,4,0,4,0,1,1,0,0,0,5,1,6
2020-03-24,0,0,0,0,0,0,0,0,0,0,0,0,0,0,0,0,0,0,1,0,1,4,1,5,0,1,1,0,0,0,5,2,7
2020-03-25,0,0,0,0,0,0,0,0,0,0,0,0,0,0,0,0,0,0,2,0,2,4,1,5,1,3,4,0,1,1,7,5,12
2020-03-26,0,0,0,0,0,0,0,0,0,0,0,0,0,0,0,1,0,1,3,0,3,5,1,6,1,3,4,0,1,1,10,5,15
2020-03-27,0,0,0,0,0,0,0,0,0,0,0,0,0,0,0,2,0,2,4,0,4,5,1,6,1,3,4,0,1,1,12,5,17
2020-03-28,0,0,0,0,0,0,0,0,0,0,0,0,0,0,0,2,0,2,4,0,4,5,1,6,3,3,6,0,1,1,14,5,19
2020-03-29,0,0,0,0,0,0,0,0,0,0,0,0,0,0,0,2,0,2,4,0,4,5,1,6,3,3,6,0,1,1,14,5,19
2020-03-30,0,0,0,0,0,0,0,0,0,0,0,0,1,0,1,2,0,2,5,0,5,7,1,8,3,3,6,0,2,2,18,6,24
2020-03-31,0,0,0,0,0,0,0,0,0,0,0,0,1,0,1,3,0,3,5,0,5,9,2,11,3,4,7,0,2,2,21,8,29
2020-04-01,0,0,0,0,0,0,0,0,0,0,0,0,1,0,1,3,0,3,7,0,7,9,2,11,3,4,7,0,2,2,23,8,31
2020-04-02,0,0,0,0,0,0,0,0,0,0,0,0,1,0,1,3,0,3,7,0,7,11,2,13,3,4,7,1,3,4,26,9,35
2020-04-03,0,0,0,0,0,0,0,0,0,0,0,0,1,0,1,3,1,4,7,1,8,12,2,14,3,5,8,1,3,4,27,12,39
2020-04-04,0,0,0,0,0,0,0,0,0,0,0,0,1,0,1,3,1,4,7,1,8,12,2,14,3,5,8,2,3,5,28,12,40
2020-04-05,0,0,0,0,0,0,0,0,0,0,0,0,1,1,2,3,1,4,7,1,8,14,2,16,3,5,8,2,3,5,30,13,43
2020-04-06,0,0,0,0,0,0,0,0,0,0,0,0,1,1,2,3,1,4,8,1,9,14,3,17,3,5,8,2,3,5,31,14,45
2020-04-07,0,0,0,0,0,0,0,0,0,0,0,0,1,1,2,3,1,4,8,1,9,14,5,19,3,5,8,3,3,6,32,16,48
2020-04-08,0,0,0,0,0,0,0,0,0,0,0,0,1,1,2,4,1,5,8,1,9,15,6,21,3,5,8,3,3,6,34,17,51
2020-04-09,0,0,0,0,0,0,0,0,0,0,0,0,1,1,2,4,1,5,8,1,9,15,6,21,3,5,8,3,3,6,34,17,51
2020-04-10,0,0,0,0,0,0,0,0,0,0,0,0,1,1,2,4,1,5,8,1,9,15,6,21,3,5,8,3,3,6,34,17,51
2020-04-11,0,0,0,0,0,0,0,0,0,0,0,0,1,1,2,4,1,5,8,1,9,15,6,21,5,5,10,3,3,6,36,17,53
2020-04-12,0,0,0,0,0,0,0,0,0,0,0,0,1,1,2,4,1,5,8,1,9,15,6,21,5,5,10,3,3,6,36,17,53
2020-04-13,0,0,0,0,0,0,0,0,0,0,0,0,1,1,2,4,1,5,8,1,9,15,6,21,5,5,10,3,3,6,36,17,53
2020-04-14,0,0,0,0,0,0,0,0,0,0,0,0,1,1,2,4,1,5,9,1,10,17,6,23,5,6,11,3,3,6,39,18,57
2020-04-15,0,0,0,0,0,0,0,0,0,0,0,0,1,1,2,4,1,5,9,1,10,17,6,23,5,6,11,3,3,6,39,18,57
2020-04-16,0,0,0,0,0,0,0,0,0,0,0,0,1,1,2,4,1,5,9,1,10,17,6,23,5,6,11,3,3,6,39,18,57
2020-04-17,0,0,0,0,0,0,1,0,1,0,0,0,1,1,2,4,1,5,9,1,10,17,7,24,7,9,16,3,4,7,42,23,65
2020-04-18,0,0,0,0,0,0,1,0,1,0,0,0,2,1,3,4,1,5,9,1,10,17,8,25,8,11,19,3,6,9,44,28,72
2020-04-19,0,0,0,0,0,0,1,0,1,0,0,0,2,1,3,4,1,5,9,1,10,17,8,25,8,11,19,4,6,10,45,28,73
2020-04-20,0,0,0,0,0,0,1,0,1,0,0,0,3,1,4,4,1,5,9,1,10,17,8,25,9,11,20,4,7,11,47,29,76
2020-04-21,0,0,0,0,0,0,1,0,1,0,0,0,3,1,4,5,1,6,10,1,11,17,8,25,11,11,22,5,10,15,52,32,84
2020-04-22,0,0,0,0,0,0,1,0,1,1,0,1,3,1,4,5,1,6,11,1,12,18,11,29,12,13,25,6,13,19,57,40,97
2020-04-23,0,0,0,0,0,0,1,0,1,1,0,1,3,1,4,5,1,6,12,2,14,20,13,33,15,13,28,6,16,22,63,46,109
2020-04-24,0,0,0,0,0,0,1,0,1,1,0,1,3,1,4,5,1,6,12,2,14,20,13,33,17,15,32,6,16,22,65,48,113
2020-04-25,0,0,0,0,0,0,1,0,1,1,0,1,3,1,4,6,1,7,12,2,14,20,13,33,17,17,34,6,16,22,66,50,116
2020-04-26,0,0,0,0,0,0,1,0,1,1,0,1,3,1,4,6,1,7,12,2,14,20,13,33,17,17,34,6,16,22,66,50,116
2020-04-27,0,0,0,0,0,0,1,0,1,1,0,1,3,1,4,6,1,7,13,2,15,21,13,34,19,18,37,7,17,24,71,52,123
2020-04-28,0,0,0,0,0,0,1,0,1,1,0,1,3,1,4,6,1,7,13,2,15,21,13,34,20,20,40,7,17,24,72,54,126
2020-04-29,0,0,0,0,0,0,1,0,1,1,0,1,3,1,4,6,1,7,13,2,15,22,13,35,20,20,40,7,17,24,73,54,127
2020-04-30,0,0,0,0,0,0,1,0,1,1,0,1,3,1,4,7,1,8,13,2,15,22,13,35,20,20,40,7,17,24,74,54,128
2020-05-01,0,0,0,0,0,0,1,0,1,1,0,1,3,1,4,7,1,8,14,2,16,22,13,35,20,21,41,8,17,25,76,55,131
2020-05-02,0,0,0,0,0,0,1,0,1,1,0,1,3,1,4,7,1,8,14,2,16,23,13,36,20,21,41,8,17,25,77,55,132
2020-05-03,0,0,0,0,0,0,1,0,1,1,0,1,3,1,4,8,1,9,15,2,17,23,13,36,21,21,42,8,17,25,80,55,135
2020-05-04,0,0,0,0,0,0,1,0,1,1,0,1,3,1,4,9,1,10,15,2,17,23,13,36,21,23,44,8,17,25,81,57,138
2020-05-05,0,0,0,0,0,0,1,0,1,2,0,2,3,2,5,9,1,10,15,2,17,24,13,37,24,23,47,8,19,27,86,60,146
2020-05-06,0,0,0,0,0,0,1,0,1,2,0,2,4,2,6,9,1,10,16,3,19,25,13,38,25,24,49,9,20,29,91,63,154
2020-05-07,0,0,0,0,0,0,1,0,1,2,0,2,4,2,6,11,1,12,16,3,19,25,14,39,26,24,50,9,22,31,94,66,160
2020-05-08,0,0,0,0,0,0,1,0,1,2,0,2,4,2,6,11,1,12,16,3,19,25,14,39,26,25,51,9,22,31,94,67,161
2020-05-09,0,0,0,0,0,0,1,0,1,2,0,2,4,2,6,11,1,12,16,4,20,25,14,39,26,25,51,10,22,32,95,68,163
2020-05-10,0,0,0,0,0,0,1,0,1,2,0,2,4,2,6,11,1,12,17,4,21,25,14,39,26,25,51,10,22,32,96,68,164
2020-05-11,0,0,0,0,0,0,1,0,1,2,0,2,5,3,8,11,1,12,18,4,22,25,14,39,26,25,51,10,22,32,98,69,167
2020-05-12,0,0,0,0,0,0,1,0,1,3,0,3,5,3,8,13,2,15,19,5,24,27,17,44,26,26,52,11,23,34,105,76,181
2020-05-13,0,0,0,0,0,0,1,0,1,3,0,3,6,3,9,13,3,16,21,5,26,27,17,44,26,27,53,11,25,36,108,80,188
2020-05-14,0,0,0,0,0,0,1,0,1,3,0,3,6,3,9,15,3,18,22,5,27,28,18,46,26,28,54,11,25,36,112,82,194
2020-05-15,0,0,0,0,0,0,1,0,1,3,0,3,6,4,10,15,3,18,22,5,27,28,19,47,26,29,55,12,26,38,113,86,199
2020-05-16,0,0,0,0,0,0,1,0,1,4,0,4,6,5,11,15,3,18,23,6,29,30,20,50,26,30,56,12,29,41,117,93,210
2020-05-17,0,1,1,0,0,0,1,0,1,4,0,4,6,6,12,18,3,21,24,6,30,31,20,51,28,33,61,12,29,41,124,98,222
2020-05-18,0,1,1,0,0,0,1,0,1,5,0,5,7,6,13,20,3,23,26,7,33,33,21,54,28,33,61,12,29,41,132,100,232
2020-05-19,0,1,1,0,0,0,1,0,1,5,0,5,8,6,14,21,3,24,26,7,33,33,21,54,28,35,63,13,29,42,135,102,237
2020-05-20,0,1,1,0,0,0,1,1,2,6,0,6,8,7,15,24,4,28,27,7,34,34,22,56,29,37,66,14,29,43,143,108,251
2020-05-21,0,1,1,0,0,0,1,1,2,6,0,6,9,7,16,24,4,28,29,7,36,34,23,57,29,38,67,14,32,46,146,113,259
2020-05-22,0,1,1,0,0,0,1,1,2,6,0,6,9,7,16,27,4,31,30,9,39,34,23,57,29,38,67,14,32,46,150,115,265
2020-05-23,0,1,1,0,0,0,1,1,2,6,0,6,12,7,19,29,4,33,30,9,39,35,23,58,31,42,73,14,33,47,158,120,278
2020-05-24,0,1,1,0,0,0,1,1,2,7,0,7,12,7,19,29,5,34,31,9,40,35,24,59,31,42,73,15,33,48,161,122,283
2020-05-25,0,1,1,0,0,0,1,1,2,7,0,7,12,8,20,30,5,35,32,11,43,36,28,64,32,43,75,16,33,49,166,130,296
2020-05-26,0,1,1,0,0,0,1,1,2,7,0,7,12,8,20,33,7,40,35,12,47,37,29,66,32,46,78,18,33,51,175,137,312
2020-05-27,0,1,1,0,0,0,1,1,2,7,0,7,14,9,23,33,7,40,36,12,48,40,32,72,33,48,81,18,34,52,182,144,326
2020-05-28,0,1,1,0,0,0,1,1,2,9,0,9,14,10,24,35,8,43,37,13,50,41,38,79,37,52,89,21,43,64,195,166,361
2020-05-29,0,1,1,0,0,0,1,1,2,9,0,9,15,11,26,36,8,44,39,13,52,43,40,83,39,58,97,21,46,67,203,178,381
2020-05-30,0,1,1,0,0,0,1,1,2,9,0,9,16,11,27,39,8,47,39,13,52,45,41,86,40,58,98,22,46,68,211,179,390
2020-05-31,0,1,1,0,0,0,1,1,2,9,0,9,17,11,28,40,10,50,39,13,52,49,42,91,43,60,103,23,46,69,221,184,405
2020-06-01,0,1,1,0,0,0,1,1,2,10,0,10,17,12,29,42,10,52,39,13,52,50,44,94,46,62,108,23,46,69,228,189,417
2020-06-02,1,1,2,0,0,0,1,1,2,10,0,10,18,14,32,43,11,54,45,13,58,52,46,98,47,64,111,25,49,74,242,199,441
2020-06-03,1,1,2,0,0,0,1,1,2,10,0,10,19,15,34,46,12,58,50,14,64,55,47,102,48,65,113,25,49,74,255,204,459
2020-06-04,1,1,2,0,0,0,1,1,2,11,0,11,19,15,34,47,13,60,53,15,68,58,49,107,48,68,116,28,53,81,266,215,481
2020-06-05,1,1,2,0,0,0,1,2,3,11,0,11,19,15,34,48,14,62,57,17,74,63,54,117,50,71,121,28,55,83,278,229,507
2020-06-06,1,1,2,0,0,0,1,2,3,11,0,11,19,15,34,51,14,65,57,17,74,66,55,121,51,77,128,29,58,87,286,239,525
2020-06-07,1,1,2,0,0,0,1,2,3,11,0,11,19,15,34,53,14,67,58,17,75,66,57,123,54,81,135,29,61,90,292,248,540
2020-06-08,1,1,2,0,0,0,1,2,3,13,0,13,21,15,36,54,14,68,58,18,76,71,59,130,59,82,141,29,63,92,307,254,561
2020-06-09,1,1,2,0,0,0,1,2,3,13,1,14,22,16,38,56,14,70,58,21,79,73,59,132,61,84,145,29,66,95,314,264,578
2020-06-10,1,1,2,0,0,0,1,2,3,13,1,14,22,17,39,58,15,73,60,22,82,77,60,137,62,92,154,30,69,99,324,279,603
2020-06-11,1,1,2,0,0,0,1,2,3,13,1,14,24,17,41,62,15,77,63,23,86,79,64,143,63,95,158,30,72,102,336,290,626
2020-06-12,1,1,2,0,0,0,1,2,3,14,1,15,24,17,41,67,16,83,64,25,89,86,64,150,66,95,161,31,74,105,354,295,649
2020-06-13,1,1,2,0,0,0,1,3,4,14,1,15,24,19,43,69,17,86,67,25,92,88,68,156,67,99,166,31,79,110,362,312,674
2020-06-14,1,1,2,0,0,0,1,3,4,14,1,15,25,19,44,69,18,87,70,25,95,90,69,159,68,101,169,32,83,115,370,320,690
2020-06-15,1,1,2,0,0,0,1,3,4,14,1,15,25,20,45,69,18,87,73,26,99,90,73,163,68,102,170,35,83,118,376,327,703
2020-06-16,1,1,2,0,0,0,2,3,5,15,1,16,26,20,46,72,18,90,76,29,105,98,75,173,69,104,173,35,86,121,394,337,731
2020-06-17,2,1,3,0,0,0,3,3,6,15,1,16,27,20,47,72,21,93,81,30,111,105,77,182,72,107,179,36,90,126,413,350,763
2020-06-18,2,1,3,0,0,0,3,3,6,17,2,19,29,20,49,76,22,98,83,31,114,106,79,185,77,108,185,37,91,128,430,357,787
2020-06-19,2,1,3,0,0,0,3,3,6,18,2,20,29,20,49,78,24,102,86,35,121,111,83,194,84,108,192,37,100,137,448,376,824
2020-06-20,2,1,3,0,0,0,3,3,6,19,2,21,29,20,49,80,25,105,87,37,124,118,87,205,87,113,200,39,103,142,464,391,855
2020-06-21,2,1,3,0,0,0,3,3,6,19,3,22,30,21,51,81,25,106,91,37,128,120,90,210,89,117,206,39,108,147,474,405,879
2020-06-22,2,1,3,0,0,0,3,4,7,20,3,23,32,21,53,81,26,107,96,41,137,126,94,220,96,123,219,41,109,150,497,422,919
2020-06-23,2,1,3,0,0,0,3,4,7,20,3,23,34,21,55,85,27,112,97,43,140,132,95,227,104,129,233,44,113,157,521,436,957
2020-06-24,2,1,3,0,0,0,3,4,7,20,3,23,34,23,57,87,28,115,100,45,145,136,96,232,110,133,243,45,119,164,537,452,989
2020-06-25,2,1,3,0,0,0,3,4,7,20,3,23,36,24,60,90,28,118,107,48,155,138,100,238,115,141,256,46,123,169,557,472,1029
2020-06-26,2,1,3,0,0,0,3,4,7,20,3,23,36,26,62,93,29,122,109,50,159,144,100,244,117,145,262,47,126,173,571,484,1055
2020-06-27,2,1,3,0,0,0,3,4,7,20,3,23,37,26,63,94,30,124,113,52,165,145,102,247,120,148,268,49,129,178,583,495,1078
2020-06-28,2,1,3,0,0,0,3,4,7,20,3,23,37,26,63,94,30,124,113,53,166,147,104,251,125,153,278,50,135,185,591,509,1100
2020-06-29,2,1,3,0,0,0,3,5,8,20,3,23,37,26,63,96,30,126,116,55,171,151,109,260,135,160,295,51,138,189,611,527,1138
2020-06-30,2,1,3,0,0,0,3,5,8,20,3,23,38,27,65,100,33,133,125,58,183,158,113,271,140,169,309,53,146,199,639,555,1194
2020-07-01,2,1,3,0,0,0,3,5,8,20,3,23,39,28,67,102,34,136,128,58,186,161,115,276,151,173,324,56,149,205,662,566,1228
2020-07-02,2,1,3,0,0,0,3,5,8,20,4,24,40,28,68,105,34,139,134,59,193,167,120,287,155,176,331,56,152,208,682,579,1261
2020-07-03,2,1,3,0,0,0,3,5,8,20,5,25,40,29,69,107,34,141,139,59,198,172,127,299,156,186,342,58,156,214,697,602,1299
2020-07-04,2,1,3,0,1,1,3,5,8,20,6,26,41,30,71,108,35,143,140,61,201,177,134,311,160,197,357,59,164,223,710,634,1344
2020-07-05,2,2,4,0,1,1,3,5,8,20,7,27,41,30,71,111,36,147,144,66,210,179,138,317,164,207,371,62,169,231,726,661,1387
2020-07-06,2,2,4,0,1,1,3,5,8,20,7,27,43,30,73,113,37,150,151,69,220,188,146,334,173,220,393,67,179,246,760,696,1456
2020-07-07,2,2,4,0,1,1,3,5,8,21,7,28,43,30,73,115,37,152,162,70,232,198,153,351,181,226,407,71,186,257,796,717,1513
2020-07-08,2,2,4,0,1,1,3,5,8,21,7,28,44,31,75,117,40,157,168,71,239,205,161,366,186,230,416,75,194,269,821,742,1563
2020-07-09,2,2,4,0,1,1,3,6,9,21,7,28,45,32,77,117,40,157,171,72,243,213,165,378,191,240,431,77,198,275,840,763,1603
2020-07-10,2,2,4,0,1,1,3,7,10,22,7,29,45,32,77,119,43,162,177,75,252,219,173,392,203,249,452,78,203,281,868,792,1660
2020-07-11,2,2,4,0,1,1,3,8,11,24,7,31,45,32,77,120,43,163,181,75,256,224,175,399,205,257,462,79,209,288,883,809,1692
2020-07-12,2,2,4,0,1,1,4,8,12,24,8,32,49,32,81,122,43,165,185,75,260,228,179,407,216,263,479,81,216,297,911,827,1738
2020-07-13,2,2,4,0,1,1,4,8,12,24,8,32,49,33,82,123,45,168,191,76,267,235,188,423,223,268,491,84,227,311,935,856,1791
2020-07-14,2,2,4,0,1,1,4,8,12,24,8,32,50,33,83,125,49,174,198,78,276,251,191,442,226,277,503,89,237,326,969,884,1853
2020-07-15,2,3,5,0,1,1,4,8,12,25,9,34,53,33,86,125,49,174,207,79,286,262,196,458,233,288,521,91,243,334,1002,909,1911
2020-07-16,2,3,5,0,1,1,4,8,12,26,9,35,53,33,86,126,49,175,214,81,295,270,200,470,244,299,543,97,250,347,1036,933,1969
2020-07-17,2,3,5,0,1,1,5,8,13,26,10,36,56,33,89,129,50,179,223,83,306,276,205,481,258,310,568,99,263,362,1074,966,2040
2020-07-18,2,3,5,0,1,1,6,9,15,26,10,36,58,34,92,129,51,180,227,83,310,282,211,493,262,318,580,101,269,370,1093,989,2082
2020-07-19,2,3,5,0,1,1,6,9,15,26,10,36,59,34,93,130,52,182,227,83,310,288,213,501,271,330,601,106,273,379,1115,1008,2123
2020-07-20,2,3,5,0,1,1,6,9,15,27,11,38,61,35,96,132,54,186,234,85,319,295,221,516,282,337,619,107,275,382,1146,1031,2177
2020-07-21,2,3,5,0,1,1,8,9,17,28,11,39,63,35,98,134,54,188,247,88,335,300,226,526,292,349,641,109,285,394,1183,1061,2244
2020-07-22,2,3,5,0,1,1,8,9,17,28,11,39,63,35,98,137,54,191,253,90,343,307,231,538,301,357,658,112,293,405,1211,1084,2295
2020-07-23,2,3,5,0,1,1,8,9,17,28,12,40,64,35,99,140,55,195,259,92,351,312,238,550,307,367,674,112,297,409,1232,1109,2341
2020-07-24,2,3,5,0,1,1,8,9,17,28,12,40,67,35,102,143,56,199,264,94,358,318,241,559,315,383,698,114,301,415,1259,1135,2394
2020-07-25,2,4,6,0,1,1,8,9,17,28,12,40,67,35,102,145,59,204,268,94,362,320,245,565,322,390,712,119,312,431,1279,1161,2440
2020-07-26,2,4,6,0,1,1,9,9,18,29,12,41,69,35,104,145,60,205,270,94,364,326,251,577,332,395,727,121,319,440,1303,1180,2483
2020-07-27,2,4,6,0,1,1,9,9,18,29,13,42,70,36,106,150,63,213,271,96,367,329,258,587,344,400,744,123,324,447,1327,1204,2531
2020-07-28,2,4,6,0,1,1,9,10,19,29,13,42,71,37,108,152,65,217,276,99,375,338,265,603,354,411,765,124,330,454,1355,1235,2590
2020-07-29,2,4,6,0,1,1,9,10,19,30,14,44,72,38,110,154,66,220,281,99,380,342,268,610,360,417,777,128,331,459,1378,1248,2626
2020-07-30,2,4,6,0,1,1,9,10,19,30,14,44,76,41,117,154,66,220,283,100,383,347,272,619,364,426,790,130,336,466,1395,1270,2665
2020-07-31,2,4,6,0,1,1,9,11,20,30,14,44,78,43,121,156,68,224,287,102,389,352,277,629,368,434,802,131,347,478,1413,1301,2714
2020-08-01,2,4,6,0,1,1,9,11,20,30,14,44,80,44,124,158,69,227,290,104,394,356,281,637,373,440,813,134,352,486,1432,1320,2752
2020-08-02,2,4,6,0,1,1,9,11,20,31,14,45,81,44,125,160,70,230,292,106,398,365,287,652,377,452,829,135,357,492,1452,1346,2798
2020-08-03,2,4,6,0,1,1,10,11,21,31,14,45,82,45,127,163,71,234,300,109,409,375,295,670,382,465,847,136,370,506,1481,1385,2866
2020-08-04,2,5,7,0,1,1,10,11,21,31,14,45,83,46,129,166,74,240,307,112,419,382,298,680,391,476,867,139,382,521,1511,1419,2930
2020-08-05,2,6,8,0,1,1,10,11,21,31,14,45,84,47,131,169,78,247,314,114,428,388,302,690,401,492,893,142,389,531,1541,1454,2995
2020-08-06,2,6,8,0,1,1,10,11,21,33,14,47,86,47,133,172,79,251,318,116,434,392,308,700,409,500,909,145,396,541,1567,1478,3045
2020-08-07,2,6,8,0,1,1,10,11,21,34,14,48,87,49,136,173,79,252,319,118,437,395,313,708,417,506,923,149,398,547,1586,1495,3081
2020-08-08,2,6,8,0,1,1,10,11,21,35,14,49,87,50,137,174,81,255,324,120,444,400,317,717,423,513,936,150,402,552,1605,1515,3120
2020-08-09,2,6,8,0,1,1,10,11,21,35,14,49,87,51,138,176,82,258,333,125,458,405,320,725,430,518,948,153,402,555,1631,1530,3161
2020-08-10,2,6,8,0,1,1,10,11,21,36,14,50,88,51,139,177,87,264,337,128,465,411,323,734,435,528,963,153,407,560,1649,1556,3205
2020-08-11,2,6,8,0,1,1,10,11,21,37,14,51,89,51,140,178,87,265,342,132,474,416,327,743,439,536,975,155,410,565,1668,1575,3243
2020-08-12,3,6,9,0,1,1,10,11,21,37,14,51,90,51,141,179,89,268,343,135,478,420,331,751,443,541,984,157,413,570,1682,1592,3274
2020-08-13,3,6,9,0,1,1,10,11,21,37,14,51,90,51,141,179,91,270,349,138,487,428,333,761,449,548,997,158,414,572,1703,1607,3310
2020-08-14,3,6,9,0,1,1,10,11,21,37,14,51,91,51,142,180,91,271,353,140,493,433,334,767,454,553,1007,159,416,575,1720,1617,3337
2020-08-15,3,6,9,0,1,1,10,12,22,37,14,51,92,51,143,181,91,272,358,143,501,441,338,779,463,564,1027,159,424,583,1744,1644,3388
2020-08-16,3,6,9,0,1,1,10,12,22,37,14,51,94,51,145,181,92,273,362,143,505,445,341,786,470,570,1040,159,430,589,1761,1660,3421
2020-08-17,3,6,9,0,1,1,10,12,22,37,15,52,95,51,146,184,93,277,366,144,510,448,343,791,473,573,1046,159,434,593,1775,1672,3447
2020-08-18,3,6,9,0,1,1,12,12,24,37,15,52,95,51,146,186,94,280,370,145,515,456,345,801,476,591,1067,161,440,601,1796,1700,3496
2020-08-19,3,6,9,0,1,1,12,13,25,38,15,53,96,51,147,188,95,283,381,146,527,459,353,812,487,601,1088,166,442,608,1830,1723,3553
2020-08-20,3,6,9,0,1,1,12,13,25,39,15,54,97,51,148,188,95,283,392,146,538,464,360,824,496,605,1101,168,449,617,1859,1741,3600
2020-08-21,3,6,9,0,1,1,12,14,26,39,15,54,99,51,150,189,95,284,400,146,546,465,365,830,500,616,1116,170,454,624,1877,1763,3640
2020-08-22,3,6,9,0,1,1,12,14,26,39,15,54,101,51,152,189,95,284,406,148,554,469,368,837,507,620,1127,171,456,627,1897,1774,3671
2020-08-23,3,6,9,0,1,1,12,14,26,40,15,55,101,51,152,191,96,287,411,151,562,474,369,843,519,624,1143,174,462,636,1925,1789,3714
2020-08-24,3,6,9,0,1,1,12,14,26,41,15,56,102,51,153,193,96,289,416,157,573,478,374,852,524,626,1150,176,467,643,1945,1807,3752
2020-08-25,3,6,9,0,1,1,12,14,26,43,15,58,104,51,155,196,97,293,418,164,582,486,380,866,535,636,1171,178,471,649,1975,1835,3810
2020-08-26,3,6,9,0,1,1,12,14,26,43,16,59,104,54,158,197,97,294,423,166,589,493,385,878,541,646,1187,180,478,658,1996,1863,3859
2020-08-27,3,6,9,0,1,1,12,14,26,44,16,60,105,55,160,201,97,298,425,168,593,502,385,887,547,658,1205,184,482,666,2023,1882,3905
2020-08-28,3,6,9,0,1,1,12,14,26,44,16,60,106,55,161,205,97,302,428,170,598,511,388,899,552,665,1217,184,483,667,2045,1895,3940
2020-08-29,3,6,9,0,1,1,12,14,26,46,16,62,106,55,161,207,98,305,430,171,601,517,392,909,558,666,1224,185,486,671,2064,1905,3969
2020-08-30,3,6,9,0,1,1,12,14,26,47,16,63,106,56,162,210,98,308,437,171,608,523,396,919,563,670,1233,187,490,677,2088,1918,4006
2020-08-31,3,6,9,0,1,1,12,14,26,47,16,63,107,56,163,211,99,310,445,172,617,537,400,937,571,676,1247,187,491,678,2120,1931,4051
2020-09-01,3,6,9,0,1,1,12,14,26,47,16,63,108,56,164,211,99,310,453,173,626,545,404,949,576,685,1261,190,496,686,2145,1950,4095
2020-09-02,3,6,9,0,1,1,12,14,26,47,16,63,108,57,165,214,103,317,458,174,632,549,407,956,585,693,1278,190,499,689,2166,1970,4136
2020-09-03,3,6,9,0,1,1,12,14,26,47,16,63,109,59,168,215,104,319,464,174,638,556,414,970,593,698,1291,192,505,697,2191,1991,4182
2020-09-04,3,6,9,0,1,1,12,15,27,47,17,64,111,59,170,216,105,321,465,177,642,558,420,978,594,702,1296,193,507,700,2199,2009,4208
2020-09-05,3,6,9,0,1,1,12,15,27,47,17,64,111,60,171,217,106,323,471,181,652,566,423,989,598,711,1309,193,510,703,2218,2030,4248
2020-09-06,3,6,9,0,1,1,12,15,27,47,17,64,112,60,172,219,106,325,475,181,656,575,427,1002,600,716,1316,196,514,710,2239,2043,4282
2020-09-07,3,6,9,0,1,1,12,15,27,47,17,64,113,61,174,222,106,328,478,186,664,584,434,1018,610,723,1333,197,519,716,2266,2068,4334
2020-09-08,3,6,9,0,1,1,12,15,27,47,17,64,113,61,174,224,107,331,483,189,672,594,440,1034,618,733,1351,200,523,723,2294,2092,4386
2020-09-09,3,6,9,0,1,1,13,15,28,47,17,64,114,62,176,230,108,338,488,192,680,602,444,1046,620,737,1357,203,530,733,2320,2112,4432
2020-09-10,3,6,9,0,1,1,13,16,29,47,17,64,114,62,176,231,108,339,490,194,684,614,447,1061,624,744,1368,204,536,740,2340,2131,4471
2020-09-11,3,6,9,0,1,1,13,16,29,48,17,65,115,63,178,232,108,340,494,196,690,619,452,1071,627,752,1379,204,537,741,2355,2148,4503
2020-09-12,3,6,9,0,1,1,13,16,29,48,17,65,115,63,178,233,110,343,496,199,695,623,454,1077,631,756,1387,204,543,747,2366,2165,4531
2020-09-13,3,6,9,0,1,1,13,16,29,48,17,65,116,63,179,233,110,343,500,201,701,628,456,1084,631,760,1391,204,544,748,2376,2174,4550
2020-09-14,3,6,9,0,1,1,14,16,30,49,17,66,116,63,179,235,110,345,502,202,704,635,462,1097,636,764,1400,205,546,751,2395,2187,4582
2020-09-15,3,6,9,0,1,1,14,16,30,49,17,66,116,63,179,237,111,348,505,204,709,640,464,1104,642,767,1409,206,549,755,2412,2198,4610
2020-09-16,3,6,9,1,1,2,14,16,30,50,17,67,116,63,179,237,112,349,510,205,715,643,469,1112,645,773,1418,207,553,760,2426,2215,4641
2020-09-17,3,6,9,1,1,2,14,16,30,50,17,67,116,63,179,237,112,349,512,206,718,650,471,1121,648,777,1425,209,557,766,2440,2226,4666
2020-09-18,3,6,9,1,1,2,15,17,32,51,17,68,116,64,180,237,113,350,516,207,723,651,475,1126,653,781,1434,209,560,769,2452,2241,4693
2020-09-19,3,6,9,1,1,2,15,17,32,51,17,68,116,64,180,238,113,351,518,210,728,655,477,1132,655,786,1441,209,563,772,2461,2254,4715
2020-09-20,3,6,9,1,1,2,15,17,32,51,17,68,119,64,183,239,113,352,521,211,732,656,480,1136,657,788,1445,209,565,774,2471,2262,4733
2020-09-21,3,6,9,1,1,2,15,17,32,51,17,68,120,64,184,239,113,352,523,211,734,662,484,1146,658,792,1450,209,567,776,2481,2272,4753
2020-09-22,3,6,9,1,1,2,15,17,32,51,17,68,120,64,184,240,114,354,525,214,739,665,485,1150,663,797,1460,210,570,780,2493,2285,4778
2020-09-23,3,6,9,1,1,2,15,17,32,51,17,68,120,65,185,244,114,358,526,217,743,671,489,1160,665,801,1466,211,572,783,2507,2299,4806
2020-09-24,3,6,9,1,1,2,15,17,32,51,17,68,120,65,185,246,115,361,529,217,746,672,491,1163,669,805,1474,213,573,786,2519,2307,4826
2020-09-25,3,6,9,1,1,2,15,17,32,51,18,69,120,66,186,248,115,363,532,218,750,679,497,1176,671,810,1481,215,579,794,2535,2327,4862
2020-09-26,3,6,9,1,1,2,15,17,32,51,18,69,120,66,186,248,115,363,533,219,752,684,499,1183,675,814,1489,216,579,795,2546,2334,4880
2020-09-27,3,6,9,1,1,2,15,17,32,51,18,69,120,66,186,248,115,363,535,220,755,688,503,1191,678,818,1496,217,581,798,2556,2345,4901
2020-09-28,3,6,9,1,1,2,15,17,32,51,18,69,120,68,188,250,115,365,541,221,762,691,504,1195,685,820,1505,219,581,800,2576,2351,4927
2020-09-29,3,6,9,1,1,2,15,17,32,52,18,70,120,68,188,251,115,366,545,222,767,694,507,1201,689,826,1515,219,583,802,2589,2363,4952
2020-09-30,3,6,9,1,1,2,16,17,33,52,18,70,120,69,189,251,115,366,549,224,773,700,507,1207,692,830,1522,222,586,808,2606,2373,4979
2020-10-01,4,6,10,1,1,2,16,17,33,52,18,70,121,69,190,252,115,367,555,227,782,703,512,1215,694,833,1527,223,588,811,2621,2386,5007
2020-10-02,4,6,10,1,1,2,16,17,33,52,18,70,121,70,191,253,115,368,558,229,787,706,518,1224,696,836,1532,225,590,815,2632,2400,5032
2020-10-03,4,6,10,1,1,2,17,17,34,52,18,70,121,70,191,253,115,368,559,229,788,710,518,1228,696,838,1534,226,590,816,2639,2402,5041
2020-10-04,4,6,10,1,1,2,17,17,34,52,18,70,122,70,192,255,115,370,560,229,789,711,520,1231,700,839,1539,226,591,817,2648,2406,5054
2020-10-05,4,6,10,1,1,2,17,17,34,52,18,70,123,70,193,257,115,372,563,231,794,714,523,1237,703,844,1547,226,593,819,2660,2418,5078
2020-10-06,4,6,10,1,1,2,17,17,34,52,18,70,123,71,194,257,115,372,564,232,796,716,524,1240,710,846,1556,227,593,820,2671,2423,5094
2020-10-07,4,6,10,1,1,2,17,17,34,52,18,70,123,71,194,257,115,372,565,232,797,717,529,1246,714,850,1564,227,594,821,2677,2433,5110
2020-10-08,4,6,10,1,1,2,17,17,34,52,18,70,123,71,194,257,115,372,567,232,799,721,534,1255,719,858,1577,228,596,824,2689,2448,5137
2020-10-09,4,6,10,1,1,2,17,17,34,52,18,70,124,71,195,260,116,376,570,233,803,725,534,1259,723,863,1586,229,597,826,2705,2456,5161
2020-10-10,4,6,10,1,1,2,17,17,34,52,18,70,126,71,197,260,116,376,571,233,804,728,536,1264,728,866,1594,229,597,826,2716,2461,5177
2020-10-11,4,6,10,1,1,2,17,17,34,53,18,71,127,72,199,261,116,377,571,234,805,730,539,1269,730,867,1597,230,597,827,2724,2467,5191
2020-10-12,4,6,10,1,1,2,17,17,34,53,18,71,128,72,200,262,116,378,573,235,808,733,540,1273,732,869,1601,230,597,827,2733,2471,5204
2020-10-13,4,6,10,1,1,2,17,17,34,53,18,71,128,72,200,265,116,381,577,237,814,735,540,1275,735,876,1611,231,597,828,2746,2480,5226
2020-10-14,4,6,10,1,1,2,18,17,35,53,18,71,129,72,201,267,116,383,578,238,816,738,544,1282,738,879,1617,232,599,831,2758,2490,5248
2020-10-15,4,6,10,1,1,2,18,17,35,53,18,71,131,72,203,267,118,385,579,238,817,741,546,1287,741,882,1623,232,600,832,2767,2498,5265
2020-10-16,4,6,10,1,1,2,18,17,35,53,18,71,132,72,204,268,118,386,581,239,820,744,548,1292,745,885,1630,233,606,839,2779,2510,5289
2020-10-17,4,6,10,1,1,2,18,18,36,53,18,71,132,74,206,268,119,387,584,240,824,747,549,1296,749,885,1634,235,608,843,2791,2518,5309
2020-10-18,4,6,10,1,1,2,19,18,37,54,18,72,132,74,206,269,119,388,584,240,824,749,551,1300,749,886,1635,235,609,844,2796,2522,5318
2020-10-19,4,7,11,1,1,2,19,18,37,54,18,72,133,74,207,269,119,388,584,241,825,752,554,1306,749,889,1638,235,609,844,2800,2530,5330
2020-10-20,4,7,11,1,1,2,19,18,37,55,18,73,133,75,208,270,119,389,585,242,827,754,555,1309,755,891,1646,236,609,845,2812,2535,5347
2020-10-21,4,7,11,1,1,2,19,18,37,55,18,73,133,75,208,271,120,391,588,244,832,756,555,1311,756,891,1647,236,609,845,2819,2538,5357
2020-10-22,4,7,11,1,1,2,19,18,37,55,18,73,133,75,208,272,120,392,588,245,833,758,557,1315,757,892,1649,236,609,845,2823,2542,5365
2020-10-23,4,7,11,1,1,2,19,18,37,55,18,73,133,75,208,273,120,393,591,247,838,759,561,1320,761,895,1656,237,610,847,2833,2552,5385
2020-10-24,4,7,11,1,1,2,19,18,37,55,18,73,133,75,208,275,120,395,593,247,840,760,564,1324,761,896,1657,237,612,849,2838,2558,5396
2020-10-25,4,7,11,1,1,2,19,18,37,56,18,74,133,75,208,275,120,395,594,248,842,761,564,1325,762,898,1660,237,613,850,2842,2562,5404
2020-10-26,4,7,11,1,1,2,19,18,37,56,18,74,133,75,208,276,120,396,597,248,845,764,566,1330,766,902,1668,239,614,853,2855,2569,5424
2020-10-27,4,7,11,1,1,2,19,18,37,56,18,74,133,76,209,279,121,400,598,248,846,766,569,1335,769,905,1674,240,614,854,2865,2577,5442
2020-10-28,4,7,11,1,1,2,20,18,38,56,18,74,133,76,209,280,121,401,599,248,847,768,569,1337,771,906,1677,242,615,857,2874,2579,5453
2020-10-29,4,7,11,1,1,2,20,18,38,56,18,74,134,76,210,280,122,402,600,248,848,770,569,1339,773,907,1680,242,615,857,2880,2581,5461
2020-10-30,4,7,11,1,1,2,20,18,38,56,18,74,134,76,210,280,123,403,601,249,850,772,569,1341,775,908,1683,243,616,859,2886,2585,5471
2020-10-31,4,7,11,1,1,2,20,18,38,56,18,74,134,76,210,280,123,403,602,249,851,773,570,1343,775,908,1683,243,616,859,2888,2586,5474
2020-11-01,4,7,11,1,1,2,20,18,38,56,18,74,134,76,210,280,123,403,602,249,851,773,571,1344,777,909,1686,243,616,859,2890,2588,5478
2020-11-02,4,7,11,1,1,2,20,18,38,56,18,74,134,76,210,281,123,404,602,249,851,773,571,1344,777,909,1686,243,617,860,2891,2589,5480
2020-11-03,4,7,11,1,1,2,20,18,38,56,18,74,134,76,210,281,123,404,602,250,852,774,574,1348,777,911,1688,243,618,861,2892,2596,5488
2020-11-04,4,7,11,1,1,2,20,18,38,56,18,74,134,76,210,281,124,405,603,250,853,775,576,1351,778,912,1690,243,619,862,2895,2601,5496
2020-11-05,4,7,11,1,2,3,20,18,38,56,18,74,134,76,210,281,124,405,606,250,856,777,577,1354,778,913,1691,244,619,863,2901,2604,5505
2020-11-06,4,7,11,1,2,3,20,18,38,56,18,74,134,77,211,281,124,405,609,250,859,779,578,1357,781,915,1696,245,620,865,2910,2609,5519
2020-11-07,4,7,11,1,2,3,20,18,38,56,18,74,134,77,211,281,124,405,609,252,861,779,579,1358,783,915,1698,245,620,865,2912,2612,5524
2020-11-08,4,7,11,1,2,3,20,18,38,56,18,74,134,77,211,281,124,405,610,252,862,780,579,1359,785,916,1701,246,620,866,2917,2613,5530
2020-11-09,4,7,11,1,2,3,20,19,39,56,18,74,134,77,211,281,124,405,611,253,864,786,580,1366,786,921,1707,246,622,868,2925,2623,5548
2020-11-10,4,7,11,1,2,3,20,19,39,56,18,74,134,77,211,282,124,406,614,253,867,787,585,1372,786,926,1712,246,622,868,2930,2633,5563
2020-11-11,4,7,11,1,2,3,20,19,39,56,18,74,134,77,211,284,125,409,614,254,868,788,586,1374,786,928,1714,247,623,870,2934,2639,5573
2020-11-12,4,7,11,1,2,3,20,19,39,56,18,74,134,77,211,284,125,409,615,254,869,789,586,1375,786,928,1714,247,625,872,2936,2641,5577
2020-11-13,4,7,11,1,2,3,20,19,39,56,18,74,134,77,211,285,125,410,616,254,870,792,586,1378,787,931,1718,248,626,874,2943,2645,5588
2020-11-14,4,7,11,1,2,3,20,19,39,56,18,74,134,77,211,286,125,411,617,254,871,794,586,1380,789,933,1722,248,626,874,2949,2647,5596
2020-11-15,4,7,11,1,2,3,20,19,39,56,18,74,134,77,211,286,125,411,619,254,873,795,587,1382,790,935,1725,249,626,875,2954,2650,5604
2020-11-16,4,7,11,1,2,3,20,19,39,56,18,74,134,77,211,286,125,411,621,254,875,796,587,1383,792,937,1729,251,628,879,2961,2654,5615
2020-11-17,4,7,11,1,2,3,20,19,39,56,18,74,134,77,211,288,125,413,624,254,878,797,587,1384,794,941,1735,251,629,880,2969,2659,5628
2020-11-18,4,7,11,1,2,3,20,19,39,56,18,74,134,77,211,288,125,413,625,254,879,800,587,1387,796,941,1737,251,630,881,2975,2660,5635
2020-11-19,4,7,11,1,2,3,20,19,39,56,18,74,134,78,212,288,125,413,625,254,879,802,587,1389,797,942,1739,251,631,882,2978,2663,5641
2020-11-20,4,7,11,1,2,3,20,19,39,56,18,74,134,78,212,288,125,413,626,254,880,803,588,1391,800,943,1743,252,631,883,2984,2665,5649
2020-11-21,4,7,11,1,2,3,20,19,39,56,18,74,134,78,212,288,125,413,626,254,880,804,588,1392,801,944,1745,252,631,883,2986,2666,5652
2020-11-22,4,7,11,1,2,3,20,19,39,56,18,74,134,78,212,289,125,414,628,254,882,805,590,1395,802,945,1747,252,632,884,2991,2670,5661
2020-11-23,4,7,11,1,2,3,20,19,39,56,18,74,134,78,212,289,125,414,628,254,882,807,592,1399,802,947,1749,252,633,885,2993,2675,5668
2020-11-24,4,7,11,1,2,3,20,19,39,56,18,74,134,78,212,289,125,414,630,254,884,808,592,1400,804,947,1751,252,634,886,2998,2676,5674
2020-11-25,4,7,11,1,2,3,20,19,39,56,18,74,136,78,214,289,125,414,631,255,886,809,593,1402,805,948,1753,253,635,888,3004,2680,5684
2020-11-26,4,7,11,1,2,3,20,19,39,58,18,76,136,78,214,289,125,414,632,255,887,809,593,1402,806,949,1755,254,636,890,3009,2682,5691
2020-11-27,4,7,11,1,2,3,20,19,39,58,18,76,136,78,214,290,125,415,633,255,888,810,595,1405,806,949,1755,255,638,893,3013,2686,5699
2020-11-28,4,7,11,1,2,3,20,19,39,58,18,76,137,78,215,290,125,415,634,255,889,810,596,1406,807,950,1757,255,638,893,3016,2688,5704
2020-11-29,4,7,11,1,2,3,20,19,39,58,18,76,137,78,215,290,125,415,635,255,890,811,596,1407,807,951,1758,256,638,894,3019,2689,5708
2020-11-30,4,7,11,1,2,3,20,19,39,58,18,76,137,78,215,290,125,415,635,255,890,812,597,1409,807,952,1759,256,639,895,3020,2692,5712
2020-12-01,4,7,11,1,2,3,20,19,39,58,18,76,137,78,215,291,125,416,635,256,891,812,598,1410,808,952,1760,256,639,895,3022,2694,5716
2020-12-02,4,7,11,1,2,3,20,19,39,58,18,76,137,78,215,291,125,416,637,258,895,812,600,1412,809,954,1763,256,644,900,3025,2705,5730
2020-12-03,4,7,11,1,2,3,20,19,39,58,18,76,137,78,215,292,125,417,638,258,896,813,602,1415,811,954,1765,256,644,900,3030,2707,5737
2020-12-04,4,7,11,1,2,3,20,19,39,58,18,76,137,78,215,292,125,417,640,258,898,814,603,1417,814,955,1769,257,644,901,3037,2709,5746
2020-12-05,4,7,11,1,2,3,20,19,39,58,18,76,137,78,215,292,125,417,640,258,898,814,605,1419,819,956,1775,257,644,901,3042,2712,5754
2020-12-06,4,7,11,1,2,3,20,19,39,58,18,76,137,78,215,292,125,417,641,258,899,815,606,1421,820,957,1777,257,644,901,3045,2714,5759
2020-12-07,4,7,11,1,2,3,20,19,39,58,18,76,137,78,215,293,125,418,642,259,901,817,607,1424,822,958,1780,257,644,901,3051,2717,5768
2020-12-08,4,7,11,1,2,3,20,19,39,58,18,76,137,78,215,293,125,418,645,260,905,818,610,1428,823,959,1782,258,645,903,3057,2723,5780
2020-12-09,4,7,11,1,2,3,20,19,39,58,19,77,137,78,215,293,125,418,647,260,907,818,611,1429,823,959,1782,258,645,903,3059,2725,5784
2020-12-10,4,7,11,1,2,3,20,19,39,58,19,77,137,78,215,295,125,420,649,260,909,820,614,1434,824,962,1786,258,647,905,3066,2733,5799
2020-12-11,4,7,11,1,2,3,20,19,39,58,19,77,137,78,215,295,126,421,650,260,910,820,615,1435,825,965,1790,258,648,906,3068,2739,5807
2020-12-12,4,7,11,1,2,3,20,19,39,58,19,77,137,78,215,295,127,422,650,260,910,822,615,1437,826,965,1791,258,648,906,3071,2740,5811
2020-12-13,4,7,11,1,2,3,20,19,39,58,19,77,138,78,216,295,127,422,651,261,912,824,615,1439,829,965,1794,259,648,907,3079,2741,5820
2020-12-14,4,7,11,1,2,3,20,19,39,58,19,77,138,78,216,295,127,422,654,262,916,827,616,1443,830,966,1796,259,648,907,3086,2744,5830
2020-12-15,4,7,11,1,2,3,20,19,39,58,19,77,138,78,216,295,127,422,656,262,918,829,618,1447,831,966,1797,259,649,908,3091,2747,5838
2020-12-16,4,7,11,1,2,3,20,19,39,58,19,77,138,78,216,295,127,422,657,263,920,832,620,1452,834,969,1803,260,650,910,3099,2754,5853
2020-12-17,4,7,11,1,2,3,20,19,39,58,19,77,138,78,216,296,127,423,657,263,920,835,624,1459,834,969,1803,260,651,911,3103,2759,5862
2020-12-18,4,7,11,1,2,3,20,19,39,59,19,78,138,78,216,298,127,425,657,264,921,839,624,1463,834,973,1807,260,654,914,3110,2767,5877
2020-12-19,4,7,11,1,2,3,20,19,39,59,19,78,138,78,216,299,127,426,659,265,924,841,624,1465,834,975,1809,260,655,915,3115,2771,5886
2020-12-20,4,7,11,1,2,3,20,19,39,59,19,78,138,78,216,299,127,426,662,267,929,841,624,1465,835,975,1810,262,656,918,3121,2774,5895
2020-12-21,4,7,11,1,2,3,20,19,39,59,19,78,139,78,217,301,127,428,665,268,933,844,625,1469,837,979,1816,263,657,920,3133,2781,5914
2020-12-22,4,7,11,1,2,3,20,19,39,59,19,78,139,78,217,302,127,429,667,268,935,845,626,1471,837,980,1817,263,658,921,3137,2784,5921
2020-12-23,4,7,11,1,2,3,20,19,39,59,19,78,139,79,218,304,127,431,670,268,938,849,629,1478,840,983,1823,263,658,921,3149,2791,5940
2020-12-24,4,7,11,1,2,3,20,19,39,59,19,78,139,79,218,304,127,431,671,268,939,849,629,1478,841,984,1825,263,659,922,3151,2793,5944
2020-12-25,4,7,11,1,2,3,20,19,39,59,19,78,140,80,220,305,127,432,672,269,941,851,629,1480,841,984,1825,263,660,923,3156,2796,5952
2020-12-26,4,7,11,1,2,3,20,19,39,59,20,79,140,80,220,307,127,434,672,269,941,855,632,1487,842,987,1829,264,660,924,3164,2803,5967
2020-12-27,4,7,11,1,2,3,20,19,39,59,20,79,141,80,221,307,127,434,675,269,944,859,633,1492,844,988,1832,264,660,924,3174,2805,5979
2020-12-28,4,7,11,1,2,3,20,19,39,59,20,79,142,80,222,308,127,435,677,270,947,866,634,1500,850,993,1843,265,661,926,3192,2813,6005
2020-12-29,4,7,11,1,2,3,20,19,39,59,20,79,142,80,222,308,128,436,682,271,953,869,635,1504,855,994,1849,266,662,928,3206,2818,6024
2020-12-30,4,7,11,1,2,3,20,19,39,59,20,79,142,80,222,310,128,438,682,272,954,873,638,1511,856,995,1851,266,662,928,3213,2823,6036
2020-12-31,4,7,11,1,2,3,20,19,39,59,20,79,142,80,222,311,128,439,683,273,956,875,640,1515,858,997,1855,266,662,928,3219,2828,6047
2021-01-01,4,7,11,1,2,3,20,19,39,59,20,79,142,80,222,311,128,439,685,274,959,878,642,1520,858,997,1855,266,662,928,3224,2831,6055
2021-01-02,4,7,11,1,2,3,20,19,39,59,20,79,143,80,223,312,130,442,685,277,962,878,642,1520,860,998,1858,269,662,931,3231,2837,6068
2021-01-03,4,7,11,1,2,3,20,19,39,59,20,79,143,80,223,315,132,447,685,277,962,880,643,1523,861,1000,1861,269,662,931,3237,2842,6079
2021-01-04,4,7,11,1,2,3,20,19,39,59,20,79,143,80,223,316,132,448,686,278,964,885,643,1528,868,1008,1876,271,663,934,3253,2852,6105
2021-01-05,4,7,11,1,2,3,20,19,39,59,21,80,144,80,224,316,132,448,689,279,968,886,643,1529,869,1010,1879,271,667,938,3259,2860,6119
2021-01-06,4,7,11,1,2,3,20,19,39,59,21,80,146,80,226,318,133,451,693,279,972,892,645,1537,869,1013,1882,271,667,938,3273,2866,6139
2021-01-07,4,7,11,1,2,3,21,19,40,59,21,80,146,81,227,318,134,452,696,281,977,896,647,1543,873,1015,1888,276,668,944,3290,2875,6165
2021-01-08,4,7,11,1,2,3,21,19,40,59,21,80,146,81,227,321,135,456,702,283,985,899,650,1549,875,1018,1893,276,669,945,3304,2885,6189
2021-01-09,4,7,11,1,2,3,21,19,40,59,21,80,147,81,228,322,136,458,702,283,985,902,653,1555,875,1021,1896,276,670,946,3309,2893,6202
2021-01-10,4,7,11,1,2,3,21,19,40,59,21,80,147,81,228,324,136,460,705,285,990,905,653,1558,877,1022,1899,276,670,946,3319,2896,6215
2021-01-11,4,7,11,1,2,3,21,19,40,59,22,81,148,81,229,326,136,462,711,285,996,910,654,1564,878,1025,1903,276,673,949,3334,2904,6238
2021-01-12,4,7,11,1,2,3,21,19,40,59,22,81,148,81,229,327,136,463,716,287,1003,914,655,1569,881,1028,1909,276,676,952,3347,2913,6260
2021-01-13,4,7,11,1,2,3,21,19,40,59,22,81,148,81,229,332,139,471,718,288,1006,918,655,1573,884,1030,1914,277,678,955,3362,2921,6283
2021-01-14,4,7,11,1,2,3,21,19,40,59,22,81,148,81,229,334,139,473,722,290,1012,923,658,1581,889,1030,1919,279,678,957,3380,2926,6306
2021-01-15,4,7,11,1,2,3,21,19,40,60,22,82,148,82,230,334,139,473,724,291,1015,925,661,1586,893,1032,1925,279,678,957,3389,2933,6322
2021-01-16,4,7,11,1,2,3,21,19,40,60,22,82,148,82,230,334,139,473,724,292,1016,927,664,1591,894,1034,1928,279,678,957,3392,2939,6331
2021-01-17,4,7,11,1,2,3,21,19,40,60,23,83,148,82,230,334,139,473,726,292,1018,933,664,1597,897,1035,1932,279,678,957,3403,2941,6344
2021-01-18,4,7,11,1,2,3,21,19,40,60,23,83,148,82,230,334,139,473,730,295,1025,935,666,1601,899,1040,1939,280,679,959,3412,2952,6364
2021-01-19,4,7,11,1,2,3,21,19,40,60,23,83,148,82,230,336,139,475,732,295,1027,938,668,1606,904,1044,1948,280,681,961,3424,2960,6384
2021-01-20,4,7,11,1,2,3,21,19,40,60,24,84,148,82,230,338,139,477,736,296,1032,942,668,1610,908,1048,1956,280,685,965,3438,2970,6408
2021-01-21,4,7,11,1,2,3,21,19,40,60,24,84,149,82,231,341,140,481,740,298,1038,945,670,1615,912,1054,1966,282,686,968,3455,2982,6437
2021-01-22,4,7,11,1,2,3,21,19,40,60,24,84,149,82,231,341,140,481,744,300,1044,946,671,1617,913,1057,1970,283,687,970,3462,2989,6451
2021-01-23,4,7,11,1,2,3,22,19,41,60,24,84,149,82,231,341,140,481,744,300,1044,952,676,1628,914,1060,1974,283,687,970,3470,2997,6467
2021-01-24,4,7,11,1,2,3,22,19,41,60,24,84,149,82,231,341,140,481,745,301,1046,954,678,1632,915,1060,1975,283,687,970,3474,3000,6474
2021-01-25,4,7,11,1,2,3,22,19,41,60,25,85,149,82,231,342,140,482,746,302,1048,958,681,1639,917,1063,1980,284,688,972,3483,3009,6492
2021-01-26,4,7,11,1,2,3,22,19,41,60,25,85,150,82,232,343,141,484,749,303,1052,960,684,1644,921,1066,1987,284,690,974,3494,3019,6513
2021-01-27,4,7,11,1,2,3,22,19,41,60,25,85,151,82,233,343,141,484,750,304,1054,963,685,1648,924,1071,1995,285,690,975,3503,3026,6529
2021-01-28,4,7,11,1,2,3,22,19,41,60,25,85,151,82,233,343,141,484,750,305,1055,965,688,1653,926,1072,1998,285,691,976,3507,3032,6539
2021-01-29,4,7,11,1,2,3,22,19,41,60,25,85,151,83,234,344,141,485,752,305,1057,969,688,1657,928,1076,2004,287,692,979,3518,3038,6556
2021-01-30,4,7,11,1,2,3,22,19,41,60,25,85,151,83,234,346,141,487,754,306,1060,969,690,1659,928,1078,2006,288,692,980,3523,3043,6566
2021-01-31,4,7,11,1,2,3,22,19,41,60,25,85,151,83,234,347,141,488,754,306,1060,975,692,1667,928,1079,2007,288,693,981,3530,3047,6577
2021-02-01,4,7,11,1,2,3,22,19,41,60,25,85,151,83,234,348,142,490,757,308,1065,979,696,1675,931,1081,2012,288,694,982,3541,3057,6598
2021-02-02,4,7,11,1,2,3,22,19,41,60,25,85,151,83,234,349,144,493,758,309,1067,982,699,1681,933,1086,2019,288,696,984,3548,3070,6618
2021-02-03,4,7,11,1,2,3,22,19,41,60,25,85,153,83,236,349,145,494,760,311,1071,985,700,1685,937,1087,2024,289,696,985,3560,3075,6635
2021-02-04,4,7,11,1,2,3,22,19,41,60,25,85,154,84,238,350,145,495,766,313,1079,991,704,1695,941,1090,2031,289,697,986,3578,3086,6664
2021-02-05,4,7,11,1,2,3,22,19,41,60,25,85,154,84,238,351,145,496,768,314,1082,994,706,1700,943,1091,2034,289,699,988,3586,3092,6678
2021-02-06,4,7,11,1,2,3,22,19,41,60,25,85,154,86,240,351,145,496,770,316,1086,998,707,1705,945,1091,2036,289,700,989,3594,3098,6692
2021-02-07,4,7,11,1,2,3,22,19,41,60,25,85,154,86,240,351,146,497,771,318,1089,1003,708,1711,949,1093,2042,289,701,990,3604,3105,6709
2021-02-08,4,7,11,1,2,3,22,19,41,60,25,85,154,86,240,354,146,500,775,318,1093,1008,717,1725,952,1096,2048,289,703,992,3619,3119,6738
2021-02-09,4,7,11,1,2,3,22,19,41,60,25,85,155,86,241,354,146,500,776,320,1096,1009,720,1729,955,1097,2052,289,703,992,3625,3125,6750
2021-02-10,4,7,11,1,2,3,22,19,41,61,25,86,155,86,241,355,146,501,777,321,1098,1011,723,1734,955,1100,2055,290,704,994,3631,3133,6764
2021-02-11,4,7,11,1,2,3,22,19,41,61,25,86,155,86,241,355,146,501,779,322,1101,1015,724,1739,956,1100,2056,291,705,996,3639,3136,6775
2021-02-12,4,7,11,1,2,3,22,19,41,61,25,86,156,86,242,356,147,503,780,324,1104,1019,729,1748,958,1103,2061,293,706,999,3650,3148,6798
2021-02-13,4,7,11,1,2,3,22,19,41,61,25,86,156,87,243,356,147,503,781,324,1105,1024,732,1756,958,1106,2064,294,707,1001,3657,3156,6813
2021-02-14,4,7,11,1,2,3,22,19,41,61,25,86,156,87,243,356,147,503,782,325,1107,1027,735,1762,958,1107,2065,294,707,1001,3661,3161,6822
2021-02-15,4,7,11,1,2,3,22,19,41,62,25,87,157,87,244,356,147,503,784,325,1109,1028,736,1764,960,1108,2068,294,708,1002,3668,3164,6832
2021-02-16,4,7,11,1,2,3,22,19,41,62,25,87,157,87,244,356,147,503,784,325,1109,1031,737,1768,962,1111,2073,294,712,1006,3673,3172,6845
2021-02-17,4,7,11,1,2,3,22,19,41,62,25,87,157,87,244,356,147,503,785,325,1110,1033,737,1770,965,1113,2078,294,712,1006,3679,3174,6853
2021-02-18,4,7,11,1,2,3,22,19,41,63,25,88,157,87,244,357,148,505,788,326,1114,1036,738,1774,965,1115,2080,294,712,1006,3687,3179,6866
2021-02-19,4,7,11,1,2,3,22,19,41,63,25,88,157,87,244,360,150,510,789,328,1117,1038,738,1776,965,1115,2080,294,712,1006,3693,3183,6876
2021-02-20,4,7,11,1,2,3,22,19,41,63,25,88,158,87,245,360,150,510,790,328,1118,1039,739,1778,966,1117,2083,295,713,1008,3698,3187,6885
2021-02-21,4,7,11,1,2,3,22,19,41,63,26,89,158,87,245,360,150,510,792,328,1120,1040,741,1781,968,1118,2086,295,714,1009,3703,3192,6895
2021-02-22,4,7,11,1,2,3,22,19,41,63,26,89,158,87,245,361,150,511,794,329,1123,1042,743,1785,970,1120,2090,297,714,1011,3712,3197,6909
2021-02-23,4,7,11,1,2,3,22,19,41,63,26,89,158,87,245,362,151,513,794,329,1123,1044,745,1789,973,1122,2095,298,714,1012,3719,3202,6921
2021-02-24,4,7,11,1,2,3,22,19,41,63,27,90,158,87,245,363,151,514,795,330,1125,1046,746,1792,973,1122,2095,300,717,1017,3725,3208,6933
2021-02-25,4,7,11,1,2,3,22,19,41,63,27,90,158,87,245,364,151,515,797,330,1127,1049,748,1797,974,1123,2097,301,717,1018,3733,3211,6944
2021-02-26,4,7,11,1,2,3,22,19,41,63,27,90,158,87,245,365,151,516,797,331,1128,1053,749,1802,975,1128,2103,303,718,1021,3741,3219,6960
2021-02-27,4,7,11,1,2,3,22,19,41,63,27,90,158,87,245,367,151,518,797,331,1128,1054,751,1805,981,1131,2112,303,719,1022,3750,3225,6975
2021-02-28,4,7,11,1,2,3,22,19,41,63,27,90,158,87,245,368,151,519,798,331,1129,1054,751,1805,981,1132,2113,303,719,1022,3752,3226,6978
2021-03-01,4,7,11,1,2,3,22,19,41,63,27,90,158,87,245,369,151,520,799,331,1130,1056,755,1811,982,1136,2118,303,719,1022,3757,3234,6991
2021-03-02,4,7,11,1,2,3,22,19,41,63,27,90,159,87,246,369,151,520,801,332,1133,1059,756,1815,984,1137,2121,303,720,1023,3765,3238,7003
2021-03-03,4,7,11,1,2,3,22,19,41,63,27,90,160,87,247,370,151,521,802,333,1135,1060,757,1817,987,1137,2124,303,720,1023,3772,3240,7012
2021-03-04,4,7,11,2,2,4,22,19,41,63,27,90,160,87,247,371,151,522,803,335,1138,1063,758,1821,988,1137,2125,304,720,1024,3780,3243,7023
2021-03-05,4,7,11,2,2,4,22,19,41,63,27,90,161,87,248,372,151,523,805,335,1140,1066,759,1825,989,1139,2128,304,720,1024,3788,3246,7034
2021-03-06,4,7,11,2,2,4,22,20,42,63,27,90,161,87,248,372,151,523,806,335,1141,1067,759,1826,990,1139,2129,304,721,1025,3791,3248,7039
2021-03-07,4,7,11,2,2,4,22,20,42,63,27,90,161,87,248,372,151,523,807,337,1144,1069,759,1828,991,1139,2130,304,722,1026,3795,3251,7046
2021-03-08,4,7,11,2,2,4,22,20,42,63,27,90,161,87,248,372,153,525,809,337,1146,1071,759,1830,994,1140,2134,305,722,1027,3803,3254,7057
2021-03-09,4,7,11,2,2,4,22,20,42,63,27,90,161,87,248,375,153,528,811,339,1150,1074,759,1833,998,1142,2140,305,723,1028,3815,3259,7074
2021-03-10,4,7,11,2,2,4,22,20,42,63,27,90,162,87,249,375,153,528,813,343,1156,1078,764,1842,998,1144,2142,305,724,1029,3822,3271,7093
2021-03-11,4,7,11,2,2,4,22,20,42,63,27,90,162,87,249,377,153,530,817,343,1160,1080,765,1845,1003,1145,2148,305,725,1030,3835,3274,7109
2021-03-12,4,7,11,2,2,4,22,20,42,63,27,90,162,88,250,378,154,532,817,343,1160,1088,768,1856,1004,1149,2153,305,730,1035,3845,3288,7133
2021-03-13,4,7,11,2,2,4,22,20,42,63,27,90,162,88,250,378,154,532,818,343,1161,1091,771,1862,1006,1149,2155,305,730,1035,3851,3291,7142
2021-03-14,4,7,11,2,2,4,22,20,42,63,27,90,163,88,251,378,154,532,819,343,1162,1094,772,1866,1009,1150,2159,305,730,1035,3859,3293,7152
2021-03-15,4,7,11,2,2,4,22,20,42,63,27,90,163,88,251,379,154,533,820,346,1166,1096,773,1869,1009,1153,2162,305,732,1037,3863,3302,7165
2021-03-16,4,7,11,2,2,4,22,20,42,63,27,90,163,88,251,381,154,535,821,347,1168,1098,773,1871,1010,1158,2168,306,732,1038,3870,3308,7178
2021-03-17,4,7,11,2,2,4,22,20,42,63,27,90,163,88,251,381,154,535,825,347,1172,1101,776,1877,1011,1158,2169,306,734,1040,3878,3313,7191
2021-03-18,4,7,11,2,2,4,22,20,42,63,27,90,164,88,252,382,154,536,825,348,1173,1104,782,1886,1012,1160,2172,306,736,1042,3884,3324,7208
2021-03-19,4,7,11,2,2,4,22,20,42,63,27,90,165,88,253,383,155,538,829,351,1180,1105,787,1892,1013,1162,2175,306,736,1042,3892,3335,7227
2021-03-20,4,7,11,2,2,4,23,20,43,63,27,90,166,88,254,383,156,539,832,353,1185,1107,787,1894,1014,1163,2177,306,736,1042,3900,3339,7239
2021-03-21,4,7,11,2,2,4,23,20,43,63,27,90,166,88,254,386,156,542,832,353,1185,1111,789,1900,1016,1166,2182,306,736,1042,3909,3344,7253
2021-03-22,4,7,11,2,2,4,23,20,43,63,27,90,166,88,254,386,156,542,835,355,1190,1112,789,1901,1020,1168,2188,307,737,1044,3918,3349,7267
2021-03-23,4,7,11,2,2,4,23,20,43,63,27,90,167,88,255,388,157,545,837,356,1193,1120,793,1913,1021,1169,2190,307,738,1045,3932,3357,7289
2021-03-24,4,7,11,2,2,4,23,20,43,63,27,90,168,89,257,388,157,545,840,357,1197,1126,793,1919,1022,1169,2191,309,739,1048,3945,3360,7305
2021-03-25,4,7,11,2,2,4,23,20,43,64,27,91,168,90,258,388,159,547,842,359,1201,1131,797,1928,1025,1174,2199,309,739,1048,3956,3374,7330
2021-03-26,4,7,11,2,2,4,23,20,43,64,27,91,169,90,259,389,159,548,845,362,1207,1139,802,1941,1030,1175,2205,309,740,1049,3974,3384,7358
2021-03-27,4,7,11,2,2,4,23,20,43,64,27,91,169,91,260,391,159,550,849,363,1212,1147,805,1952,1037,1179,2216,310,742,1052,3996,3395,7391
2021-03-28,4,7,11,2,2,4,23,20,43,64,28,92,171,91,262,393,160,553,850,366,1216,1155,808,1963,1038,1179,2217,310,742,1052,4010,3403,7413
2021-03-29,4,7,11,2,2,4,23,20,43,64,28,92,171,91,262,397,161,558,856,368,1224,1169,812,1981,1042,1182,2224,312,745,1057,4040,3416,7456
2021-03-30,4,7,11,2,2,4,23,20,43,65,29,94,173,91,264,398,162,560,863,368,1231,1176,814,1990,1043,1187,2230,315,746,1061,4062,3426,7488
2021-03-31,4,7,11,2,2,4,23,20,43,65,29,94,173,92,265,402,162,564,871,370,1241,1182,821,2003,1044,1189,2233,315,747,1062,4081,3439,7520
2021-04-01,4,7,11,2,2,4,23,20,43,65,30,95,174,92,266,407,163,570,878,372,1250,1188,822,2010,1045,1191,2236,317,747,1064,4103,3446,7549
2021-04-02,4,7,11,2,2,4,23,20,43,66,30,96,176,92,268,410,164,574,884,375,1259,1191,825,2016,1046,1193,2239,318,747,1065,4120,3455,7575
2021-04-03,4,7,11,2,2,4,23,20,43,66,30,96,178,92,270,414,164,578,887,378,1265,1202,829,2031,1048,1193,2241,320,748,1068,4144,3463,7607
2021-04-04,5,7,12,2,2,4,24,20,44,66,31,97,178,93,271,416,164,580,895,380,1275,1210,831,2041,1051,1194,2245,321,749,1070,4168,3471,7639
2021-04-05,5,7,12,2,2,4,24,20,44,66,31,97,179,94,273,417,165,582,904,387,1291,1216,835,2051,1056,1200,2256,321,750,1071,4190,3491,7681
2021-04-06,5,7,12,2,2,4,24,20,44,66,31,97,180,94,274,422,169,591,911,390,1301,1225,841,2066,1063,1202,2265,323,753,1076,4221,3509,7730
2021-04-07,5,7,12,2,2,4,25,20,45,68,31,99,182,95,277,425,173,598,916,395,1311,1234,845,2079,1065,1203,2268,325,757,1082,4247,3528,7775
2021-04-08,5,7,12,2,2,4,25,20,45,68,31,99,183,95,278,430,174,604,922,398,1320,1245,849,2094,1069,1204,2273,326,759,1085,4275,3539,7814
2021-04-09,5,7,12,2,2,4,25,20,45,68,31,99,186,95,281,434,174,608,935,404,1339,1251,853,2104,1074,1206,2280,327,762,1089,4307,3554,7861
2021-04-10,5,7,12,2,2,4,25,20,45,68,32,100,186,95,281,441,174,615,942,408,1350,1258,858,2116,1075,1208,2283,328,764,1092,4330,3568,7898
2021-04-11,5,7,12,2,2,4,25,21,46,69,32,101,186,95,281,446,176,622,954,412,1366,1268,869,2137,1077,1213,2290,330,768,1098,4362,3595,7957
2021-04-12,5,7,12,2,2,4,25,22,47,69,33,102,187,95,282,450,179,629,958,417,1375,1277,879,2156,1078,1217,2295,330,769,1099,4381,3620,8001
2021-04-13,5,7,12,2,2,4,25,22,47,69,33,102,188,98,286,459,180,639,968,419,1387,1291,886,2177,1083,1223,2306,330,772,1102,4420,3642,8062
2021-04-14,6,7,13,2,2,4,25,22,47,70,34,104,191,98,289,468,182,650,982,427,1409,1308,891,2199,1085,1224,2309,332,775,1107,4469,3662,8131
2021-04-15,6,7,13,2,2,4,25,22,47,71,34,105,191,98,289,471,186,657,989,431,1420,1313,899,2212,1088,1230,2318,332,777,1109,4488,3686,8174
2021-04-16,6,7,13,2,2,4,25,22,47,71,34,105,192,99,291,473,187,660,997,437,1434,1326,901,2227,1093,1234,2327,334,779,1113,4519,3702,8221
2021-04-17,6,7,13,2,2,4,25,22,47,72,34,106,194,100,294,479,189,668,1009,444,1453,1338,913,2251,1095,1239,2334,335,779,1114,4555,3729,8284
2021-04-18,6,7,13,2,2,4,25,22,47,72,34,106,195,101,296,484,190,674,1016,448,1464,1345,920,2265,1102,1244,2346,335,783,1118,4582,3751,8333
2021-04-19,6,7,13,2,2,4,25,22,47,72,35,107,196,101,297,488,192,680,1024,456,1480,1358,923,2281,1104,1253,2357,335,785,1120,4610,3776,8386
2021-04-20,6,7,13,2,2,4,25,22,47,72,35,107,199,105,304,492,193,685,1032,460,1492,1367,926,2293,1112,1261,2373,337,787,1124,4644,3798,8442
2021-04-21,6,7,13,2,2,4,25,22,47,72,35,107,199,107,306,503,200,703,1040,468,1508,1384,929,2313,1120,1268,2388,338,790,1128,4689,3828,8517
2021-04-22,6,7,13,2,2,4,26,22,48,72,35,107,201,108,309,505,201,706,1048,473,1521,1395,938,2333,1128,1272,2400,340,793,1133,4723,3851,8574
2021-04-23,6,7,13,2,2,4,26,22,48,73,35,108,203,108,311,510,203,713,1056,480,1536,1398,941,2339,1134,1272,2406,341,799,1140,4749,3869,8618
2021-04-24,6,7,13,2,2,4,26,22,48,75,36,111,204,108,312,519,203,722,1064,484,1548,1406,943,2349,1135,1278,2413,341,799,1140,4778,3882,8660
2021-04-25,6,7,13,2,2,4,26,22,48,76,36,112,204,109,313,523,203,726,1071,490,1561,1413,948,2361,1140,1283,2423,342,799,1141,4803,3899,8702
2021-04-26,6,7,13,2,2,4,27,22,49,77,36,113,204,109,313,528,204,732,1079,497,1576,1418,959,2377,1142,1289,2431,344,801,1145,4827,3926,8753
2021-04-27,6,7,13,2,2,4,27,22,49,78,37,115,206,110,316,534,207,741,1090,501,1591,1428,965,2393,1149,1294,2443,346,802,1148,4866,3947,8813
2021-04-28,6,7,13,2,2,4,28,22,50,79,39,118,208,113,321,540,209,749,1103,508,1611,1434,971,2405,1149,1296,2445,347,803,1150,4896,3970,8866
2021-04-29,7,7,14,2,2,4,28,22,50,79,39,118,211,114,325,547,212,759,1113,518,1631,1437,982,2419,1152,1299,2451,347,803,1150,4923,3998,8921
2021-04-30,7,7,14,2,2,4,28,22,50,79,39,118,213,116,329,548,213,761,1119,527,1646,1446,990,2436,1156,1299,2455,349,805,1154,4947,4020,8967
2021-05-01,7,7,14,2,2,4,28,23,51,82,39,121,213,116,329,549,216,765,1127,533,1660,1453,993,2446,1157,1301,2458,349,807,1156,4967,4037,9004
2021-05-02,7,7,14,2,2,4,28,23,51,83,39,122,214,116,330,552,218,770,1133,534,1667,1458,996,2454,1160,1304,2464,350,809,1159,4987,4048,9035
2021-05-03,7,7,14,2,2,4,28,23,51,84,41,125,214,116,330,558,219,777,1140,537,1677,1464,1004,2468,1164,1312,2476,354,810,1164,5015,4071,9086
2021-05-04,8,7,15,2,2,4,29,23,52,84,41,125,214,118,332,562,221,783,1153,543,1696,1472,1011,2483,1167,1318,2485,355,812,1167,5046,4096,9142
2021-05-05,8,7,15,2,2,4,29,23,52,84,42,126,217,119,336,569,225,794,1165,548,1713,1474,1016,2490,1172,1322,2494,358,814,1172,5078,4118,9196
2021-05-06,8,7,15,2,2,4,29,23,52,84,42,126,224,120,344,577,226,803,1174,552,1726,1477,1018,2495,1176,1325,2501,358,816,1174,5109,4131,9240
2021-05-07,8,7,15,2,2,4,29,23,52,84,42,126,225,121,346,581,227,808,1180,556,1736,1479,1022,2501,1183,1329,2512,358,818,1176,5129,4147,9276
2021-05-08,8,7,15,3,2,5,29,23,52,85,42,127,226,121,347,588,227,815,1186,559,1745,1483,1025,2508,1185,1332,2517,360,822,1182,5153,4160,9313
2021-05-09,8,7,15,3,2,5,29,23,52,85,42,127,227,122,349,589,227,816,1193,565,1758,1488,1027,2515,1187,1335,2522,360,825,1185,5169,4175,9344
2021-05-10,8,7,15,3,2,5,29,23,52,85,42,127,229,122,351,592,229,821,1204,570,1774,1499,1032,2531,1191,1345,2536,362,828,1190,5202,4200,9402
2021-05-11,8,7,15,3,2,5,29,23,52,87,42,129,232,122,354,594,232,826,1210,573,1783,1505,1040,2545,1196,1348,2544,365,830,1195,5229,4219,9448
2021-05-12,8,7,15,3,2,5,29,23,52,88,42,130,234,123,357,600,233,833,1220,575,1795,1508,1043,2551,1199,1349,2548,368,831,1199,5257,4228,9485
2021-05-13,8,7,15,3,2,5,30,25,55,89,42,131,235,123,358,606,236,842,1226,578,1804,1513,1046,2559,1200,1351,2551,369,832,1201,5279,4242,9521
2021-05-14,8,7,15,3,2,5,30,25,55,90,43,133,238,124,362,609,241,850,1228,582,1810,1519,1052,2571,1202,1356,2558,369,835,1204,5296,4267,9563
2021-05-15,8,7,15,3,2,5,30,25,55,90,43,133,240,125,365,613,243,856,1232,585,1817,1525,1059,2584,1206,1356,2562,369,836,1205,5316,4281,9597
2021-05-16,8,7,15,3,2,5,30,25,55,93,45,138,242,125,367,619,244,863,1238,589,1827,1532,1062,2594,1206,1360,2566,370,840,1210,5341,4299,9640
2021-05-17,8,7,15,3,2,5,31,25,56,94,46,140,244,128,372,622,252,874,1250,593,1843,1542,1069,2611,1213,1366,2579,373,841,1214,5380,4329,9709
2021-05-18,8,7,15,3,2,5,31,25,56,94,46,140,247,129,376,627,253,880,1257,596,1853,1549,1074,2623,1214,1371,2585,375,843,1218,5405,4346,9751
2021-05-19,8,7,15,4,2,6,31,25,56,94,46,140,250,130,380,633,254,887,1270,600,1870,1555,1079,2634,1219,1374,2593,377,845,1222,5441,4362,9803
2021-05-20,8,7,15,4,2,6,31,25,56,95,47,142,254,133,387,641,256,897,1280,603,1883,1565,1088,2653,1223,1378,2601,377,847,1224,5478,4386,9864
2021-05-21,9,7,16,4,2,6,31,25,56,96,47,143,256,133,389,648,257,905,1289,608,1897,1569,1093,2662,1225,1381,2606,379,848,1227,5506,4401,9907
2021-05-22,9,7,16,4,2,6,31,25,56,96,47,143,258,134,392,651,261,912,1299,614,1913,1575,1097,2672,1228,1387,2615,381,853,1234,5532,4427,9959
2021-05-23,9,7,16,4,3,7,31,25,56,97,47,144,258,134,392,657,263,920,1303,615,1918,1582,1102,2684,1235,1390,2625,383,855,1238,5559,4441,10000
2021-05-24,9,7,16,4,3,7,32,26,58,100,47,147,262,136,398,661,264,925,1311,616,1927,1592,1106,2698,1241,1393,2634,384,857,1241,5596,4455,10051
2021-05-25,9,7,16,4,3,7,32,26,58,103,47,150,267,137,404,663,265,928,1315,619,1934,1594,1107,2701,1247,1395,2642,384,858,1242,5618,4464,10082
2021-05-26,9,7,16,4,3,7,32,27,59,103,47,150,268,137,405,674,266,940,1323,625,1948,1603,1115,2718,1254,1405,2659,384,859,1243,5654,4491,10145
2021-05-27,9,7,16,4,3,7,33,27,60,105,48,153,269,137,406,681,268,949,1331,625,1956,1611,1119,2730,1258,1412,2670,385,862,1247,5686,4508,10194
2021-05-28,9,7,16,4,3,7,33,27,60,106,48,154,270,138,408,686,271,957,1336,627,1963,1614,1122,2736,1258,1417,2675,387,862,1249,5703,4522,10225
2021-05-29,9,7,16,4,3,7,33,27,60,106,48,154,271,138,409,693,271,964,1338,634,1972,1618,1124,2742,1259,1420,2679,387,862,1249,5718,4534,10252
2021-05-30,9,7,16,4,3,7,33,28,61,106,48,154,274,139,413,696,271,967,1341,640,1981,1622,1126,2748,1263,1423,2686,387,863,1250,5735,4548,10283
2021-05-31,9,7,16,4,3,7,33,28,61,107,48,155,275,141,416,704,276,980,1345,642,1987,1624,1128,2752,1270,1425,2695,388,865,1253,5759,4563,10322
2021-06-01,9,7,16,4,3,7,33,28,61,107,48,155,277,142,419,709,278,987,1351,643,1994,1628,1131,2759,1273,1430,2703,391,867,1258,5782,4577,10359
2021-06-02,9,7,16,4,3,7,33,28,61,107,48,155,277,142,419,712,283,995,1355,644,1999,1634,1135,2769,1278,1435,2713,394,870,1264,5803,4595,10398
2021-06-03,9,7,16,4,3,7,33,28,61,107,48,155,279,143,422,716,286,1002,1357,648,2005,1641,1140,2781,1283,1439,2722,397,870,1267,5826,4612,10438
2021-06-04,9,7,16,4,3,7,33,28,61,108,48,156,282,143,425,723,287,1010,1359,650,2009,1644,1141,2785,1287,1447,2734,397,871,1268,5846,4625,10471
2021-06-05,9,7,16,4,3,7,33,28,61,108,48,156,283,143,426,726,288,1014,1364,654,2018,1648,1143,2791,1293,1452,2745,398,873,1271,5866,4639,10505
2021-06-06,9,8,17,4,3,7,33,28,61,108,49,157,284,143,427,730,289,1019,1366,654,2020,1650,1144,2794,1294,1454,2748,400,875,1275,5878,4647,10525
2021-06-07,9,8,17,4,3,7,33,28,61,109,49,158,286,143,429,737,291,1028,1372,655,2027,1652,1147,2799,1302,1458,2760,402,878,1280,5906,4660,10566
2021-06-08,9,9,18,4,3,7,33,28,61,109,49,158,288,143,431,740,294,1034,1376,657,2033,1662,1149,2811,1307,1462,2769,403,878,1281,5931,4672,10603
2021-06-09,9,9,18,4,3,7,33,28,61,110,49,159,292,144,436,742,296,1038,1379,659,2038,1666,1150,2816,1314,1463,2777,403,879,1282,5952,4680,10632
2021-06-10,9,9,18,4,3,7,35,28,63,110,49,159,294,146,440,744,297,1041,1380,662,2042,1672,1154,2826,1318,1465,2783,405,882,1287,5971,4695,10666
2021-06-11,9,9,18,4,3,7,35,28,63,111,50,161,296,146,442,746,298,1044,1382,663,2045,1676,1158,2834,1321,1468,2789,407,884,1291,5987,4707,10694
2021-06-12,9,9,18,5,3,8,35,28,63,111,50,161,297,148,445,748,299,1047,1382,664,2046,1678,1160,2838,1321,1471,2792,407,886,1293,5993,4718,10711
2021-06-13,9,9,18,5,3,8,35,28,63,111,50,161,301,148,449,752,299,1051,1385,666,2051,1678,1162,2840,1326,1473,2799,407,888,1295,6009,4726,10735
2021-06-14,9,9,18,5,3,8,35,28,63,112,51,163,303,148,451,754,300,1054,1388,667,2055,1682,1164,2846,1329,1477,2806,408,890,1298,6025,4737,10762
2021-06-15,9,9,18,5,3,8,35,29,64,112,51,163,304,148,452,756,300,1056,1391,668,2059,1685,1167,2852,1331,1485,2816,408,893,1301,6036,4753,10789
2021-06-16,9,9,18,5,3,8,35,29,64,112,52,164,306,148,454,757,300,1057,1393,669,2062,1688,1171,2859,1332,1486,2818,409,896,1305,6046,4763,10809
2021-06-17,9,9,18,5,3,8,36,29,65,113,52,165,306,148,454,763,303,1066,1395,671,2066,1693,1173,2866,1334,1487,2821,409,896,1305,6063,4771,10834
2021-06-18,9,9,18,5,3,8,36,29,65,113,52,165,306,148,454,763,304,1067,1401,671,2072,1696,1174,2870,1334,1490,2824,410,897,1307,6073,4777,10850
2021-06-19,9,9,18,5,3,8,36,29,65,113,52,165,308,148,456,764,307,1071,1405,672,2077,1697,1180,2877,1335,1493,2828,411,898,1309,6083,4791,10874
2021-06-20,9,9,18,5,3,8,36,29,65,113,52,165,308,148,456,767,308,1075,1407,673,2080,1699,1181,2880,1336,1494,2830,411,900,1311,6091,4797,10888
2021-06-21,9,9,18,5,3,8,36,29,65,113,53,166,308,148,456,769,310,1079,1407,674,2081,1700,1183,2883,1337,1494,2831,411,902,1313,6095,4805,10900
2021-06-22,9,9,18,5,3,8,36,30,66,113,54,167,311,148,459,773,311,1084,1408,675,2083,1703,1186,2889,1339,1496,2835,411,903,1314,6108,4815,10923
2021-06-23,9,9,18,5,3,8,36,30,66,113,54,167,312,149,461,774,311,1085,1411,678,2089,1706,1189,2895,1342,1499,2841,411,904,1315,6119,4826,10945
2021-06-24,9,9,18,5,3,8,36,30,66,114,54,168,313,149,462,777,314,1091,1415,680,2095,1706,1192,2898,1344,1503,2847,413,904,1317,6132,4838,10970
2021-06-25,9,9,18,5,3,8,36,30,66,114,54,168,315,149,464,778,314,1092,1419,681,2100,1706,1193,2899,1345,1505,2850,413,906,1319,6140,4844,10984
2021-06-26,10,9,19,5,3,8,36,30,66,115,54,169,316,149,465,783,314,1097,1422,681,2103,1708,1195,2903,1348,1508,2856,413,908,1321,6156,4851,11007
2021-06-27,10,9,19,5,3,8,36,30,66,115,54,169,318,149,467,783,314,1097,1424,682,2106,1710,1198,2908,1349,1509,2858,413,909,1322,6163,4857,11020
2021-06-28,10,9,19,5,3,8,36,30,66,115,54,169,319,149,468,784,314,1098,1427,683,2110,1713,1201,2914,1350,1511,2861,413,909,1322,6172,4863,11035
2021-06-29,10,9,19,5,3,8,36,30,66,115,54,169,320,149,469,785,315,1100,1428,684,2112,1717,1205,2922,1352,1514,2866,414,911,1325,6182,4874,11056
2021-06-30,10,9,19,5,3,8,36,30,66,116,54,170,320,149,469,785,316,1101,1429,686,2115,1719,1208,2927,1353,1515,2868,415,911,1326,6188,4881,11069
2021-07-01,10,9,19,5,3,8,36,30,66,116,54,170,321,149,470,785,317,1102,1432,686,2118,1719,1209,2928,1355,1517,2872,415,912,1327,6194,4886,11080
2021-07-02,10,9,19,5,3,8,36,30,66,116,54,170,322,149,471,786,317,1103,1435,686,2121,1722,1211,2933,1356,1517,2873,415,914,1329,6203,4890,11093
2021-07-03,10,9,19,5,3,8,36,30,66,116,54,170,322,149,471,788,317,1105,1435,686,2121,1724,1213,2937,1358,1520,2878,415,915,1330,6209,4896,11105
2021-07-04,10,9,19,5,3,8,36,30,66,116,54,170,322,149,471,790,317,1107,1436,686,2122,1726,1213,2939,1358,1521,2879,415,916,1331,6214,4898,11112
2021-07-05,10,9,19,5,3,8,36,30,66,116,54,170,323,150,473,791,318,1109,1438,687,2125,1727,1214,2941,1360,1522,2882,416,916,1332,6222,4903,11125
2021-07-06,10,9,19,5,3,8,37,30,67,116,54,170,323,150,473,792,319,1111,1439,687,2126,1729,1217,2946,1364,1524,2888,417,916,1333,6232,4909,11141
2021-07-07,10,9,19,5,3,8,37,30,67,116,54,170,323,150,473,796,319,1115,1440,687,2127,1732,1219,2951,1366,1524,2890,418,916,1334,6243,4911,11154
2021-07-08,10,9,19,5,3,8,37,30,67,117,54,171,324,150,474,797,319,1116,1440,689,2129,1736,1220,2956,1367,1526,2893,418,917,1335,6251,4917,11168
2021-07-09,10,9,19,5,3,8,37,30,67,117,54,171,324,150,474,797,319,1116,1440,689,2129,1736,1220,2956,1369,1526,2895,418,917,1335,6253,4917,11170
2021-07-10,10,9,19,5,3,8,37,30,67,118,54,172,324,151,475,797,319,1116,1440,689,2129,1736,1222,2958,1371,1527,2898,419,919,1338,6257,4923,11180
2021-07-11,10,9,19,5,3,8,37,30,67,118,54,172,324,151,475,797,320,1117,1442,689,2131,1737,1223,2960,1371,1527,2898,419,919,1338,6260,4925,11185
2021-07-12,10,9,19,5,3,8,37,30,67,118,54,172,325,152,477,798,320,1118,1445,689,2134,1743,1223,2966,1371,1527,2898,419,921,1340,6271,4928,11199
2021-07-13,10,9,19,5,3,8,37,30,67,119,54,173,325,153,478,799,321,1120,1450,690,2140,1746,1225,2971,1374,1529,2903,419,921,1340,6284,4935,11219
2021-07-14,10,9,19,5,3,8,37,30,67,119,54,173,325,153,478,802,322,1124,1450,691,2141,1746,1227,2973,1374,1533,2907,419,921,1340,6287,4943,11230
2021-07-15,10,9,19,5,3,8,37,30,67,119,54,173,325,153,478,802,323,1125,1451,691,2142,1749,1228,2977,1375,1533,2908,420,922,1342,6293,4946,11239
2021-07-16,10,9,19,5,3,8,37,30,67,119,54,173,326,153,479,802,323,1125,1452,691,2143,1750,1228,2978,1375,1536,2911,420,922,1342,6296,4949,11245
2021-07-17,10,9,19,5,3,8,37,30,67,119,54,173,327,153,480,804,323,1127,1453,692,2145,1751,1230,2981,1375,1537,2912,421,922,1343,6302,4953,11255
2021-07-18,10,9,19,5,3,8,37,30,67,119,54,173,327,153,480,804,323,1127,1453,692,2145,1751,1231,2982,1378,1538,2916,421,922,1343,6305,4955,11260
2021-07-19,11,10,21,5,3,8,38,30,68,119,54,173,327,154,481,804,323,1127,1455,692,2147,1751,1232,2983,1380,1538,2918,422,922,1344,6312,4958,11270
2021-07-20,11,10,21,5,3,8,38,30,68,119,54,173,327,155,482,804,323,1127,1455,692,2147,1753,1233,2986,1381,1539,2920,422,922,1344,6315,4961,11276
2021-07-21,11,10,21,5,3,8,38,30,68,119,54,173,327,155,482,805,324,1129,1455,692,2147,1756,1237,2993,1381,1539,2920,422,922,1344,6319,4966,11285
2021-07-22,11,10,21,5,3,8,38,30,68,119,54,173,327,155,482,807,324,1131,1457,693,2150,1758,1238,2996,1381,1540,2921,422,922,1344,6325,4969,11294
2021-07-23,11,10,21,5,3,8,38,30,68,119,54,173,328,155,483,807,325,1132,1458,694,2152,1762,1239,3001,1382,1541,2923,422,923,1345,6332,4974,11306
2021-07-24,11,10,21,5,3,8,38,31,69,119,54,173,328,155,483,807,325,1132,1459,694,2153,1763,1239,3002,1382,1541,2923,422,923,1345,6334,4975,11309
2021-07-25,11,10,21,5,3,8,38,31,69,119,54,173,329,155,484,808,325,1133,1459,694,2153,1764,1240,3004,1382,1541,2923,422,924,1346,6337,4977,11314
2021-07-26,11,10,21,5,3,8,39,31,70,119,54,173,330,155,485,809,325,1134,1459,694,2153,1769,1242,3011,1383,1542,2925,422,925,1347,6346,4981,11327
2021-07-27,11,10,21,5,3,8,40,31,71,119,54,173,330,155,485,810,326,1136,1459,694,2153,1771,1242,3013,1383,1542,2925,423,926,1349,6351,4983,11334
2021-07-28,11,10,21,5,3,8,40,31,71,119,54,173,330,155,485,810,326,1136,1459,694,2153,1771,1242,3013,1384,1543,2927,423,926,1349,6352,4984,11336
2021-07-29,11,10,21,5,3,8,40,31,71,119,54,173,330,155,485,811,326,1137,1459,694,2153,1771,1243,3014,1385,1544,2929,423,926,1349,6354,4986,11340
2021-07-30,11,10,21,5,3,8,40,31,71,119,54,173,330,155,485,811,326,1137,1462,695,2157,1771,1244,3015,1385,1545,2930,423,927,1350,6357,4990,11347
2021-07-31,11,10,21,5,3,8,40,31,71,119,54,173,330,156,486,811,326,1137,1462,695,2157,1773,1244,3017,1385,1546,2931,423,927,1350,6359,4992,11351
2021-08-01,11,10,21,5,3,8,40,31,71,119,54,173,331,156,487,811,326,1137,1462,695,2157,1773,1244,3017,1386,1547,2933,423,927,1350,6361,4993,11354
2021-08-02,11,10,21,5,3,8,40,31,71,119,54,173,331,156,487,811,326,1137,1463,695,2158,1773,1247,3020,1386,1551,2937,423,927,1350,6362,5000,11362
2021-08-03,11,10,21,5,3,8,40,31,71,119,54,173,331,156,487,811,326,1137,1463,695,2158,1775,1247,3022,1387,1551,2938,423,929,1352,6365,5002,11367
2021-08-04,11,10,21,5,3,8,40,31,71,119,54,173,332,156,488,811,326,1137,1464,695,2159,1777,1247,3024,1387,1552,2939,424,930,1354,6370,5004,11374
2021-08-05,11,10,21,5,3,8,40,31,71,119,54,173,332,156,488,812,326,1138,1464,695,2159,1777,1249,3026,1387,1554,2941,424,931,1355,6371,5009,11380
2021-08-06,11,10,21,5,3,8,40,31,71,119,54,173,332,156,488,813,326,1139,1465,695,2160,1777,1249,3026,1387,1554,2941,424,931,1355,6373,5009,11382
2021-08-07,11,10,21,5,3,8,40,31,71,119,54,173,332,156,488,813,326,1139,1467,697,2164,1777,1249,3026,1387,1556,2943,424,931,1355,6375,5013,11388
2021-08-08,11,10,21,5,3,8,40,31,71,119,54,173,332,156,488,813,326,1139,1467,697,2164,1777,1251,3028,1387,1556,2943,424,931,1355,6375,5015,11390
2021-08-09,11,10,21,5,3,8,41,31,72,119,54,173,332,156,488,813,326,1139,1467,698,2165,1777,1253,3030,1387,1557,2944,424,931,1355,6376,5019,11395
2021-08-10,11,10,21,5,3,8,41,31,72,119,54,173,332,156,488,814,326,1140,1467,698,2165,1777,1253,3030,1387,1557,2944,424,931,1355,6377,5019,11396
2021-08-11,11,10,21,5,3,8,41,31,72,119,54,173,333,156,489,814,326,1140,1467,698,2165,1779,1254,3033,1387,1560,2947,424,932,1356,6380,5024,11404
2021-08-12,11,10,21,5,3,8,41,31,72,119,54,173,333,156,489,814,326,1140,1468,699,2167,1780,1255,3035,1388,1561,2949,424,932,1356,6383,5027,11410
2021-08-13,11,10,21,5,3,8,41,31,72,119,54,173,333,156,489,815,326,1141,1469,699,2168,1780,1256,3036,1389,1562,2951,424,932,1356,6386,5029,11415
2021-08-14,11,10,21,5,3,8,41,31,72,119,54,173,333,156,489,815,326,1141,1469,699,2168,1783,1257,3040,1389,1562,2951,424,932,1356,6389,5030,11419
2021-08-15,11,10,21,5,3,8,41,31,72,120,54,174,334,156,490,815,327,1142,1469,699,2168,1783,1257,3040,1389,1562,2951,425,932,1357,6392,5031,11423
2021-08-16,11,10,21,5,3,8,41,31,72,120,54,174,334,157,491,815,327,1142,1469,699,2168,1783,1257,3040,1390,1562,2952,425,932,1357,6393,5032,11425
2021-08-17,11,10,21,5,3,8,41,31,72,120,54,174,334,157,491,815,327,1142,1469,699,2168,1783,1258,3041,1391,1564,2955,425,933,1358,6394,5036,11430
2021-08-18,11,10,21,5,3,8,41,31,72,120,54,174,334,157,491,815,327,1142,1469,699,2168,1783,1260,3043,1392,1564,2956,425,933,1358,6395,5038,11433
2021-08-19,11,10,21,5,3,8,41,32,73,120,54,174,334,157,491,816,327,1143,1469,699,2168,1784,1260,3044,1393,1565,2958,425,933,1358,6398,5040,11438
2021-08-20,11,10,21,5,3,8,41,32,73,120,54,174,334,157,491,816,327,1143,1469,699,2168,1784,1261,3045,1394,1565,2959,425,933,1358,6399,5041,11440
2021-08-21,11,10,21,5,3,8,41,32,73,120,54,174,335,157,492,816,327,1143,1469,699,2168,1784,1261,3045,1395,1566,2961,425,933,1358,6401,5042,11443
2021-08-22,11,10,21,5,3,8,41,32,73,120,54,174,335,157,492,816,327,1143,1469,700,2169,1784,1262,3046,1396,1566,2962,425,934,1359,6402,5045,11447
2021-08-23,11,10,21,5,3,8,41,32,73,120,54,174,336,157,493,816,327,1143,1469,700,2169,1784,1262,3046,1397,1566,2963,426,934,1360,6405,5045,11450
2021-08-24,11,10,21,5,3,8,41,32,73,120,54,174,336,158,494,816,327,1143,1470,700,2170,1784,1264,3048,1397,1566,2963,426,934,1360,6406,5048,11454
2021-08-25,11,10,21,5,3,8,41,32,73,120,54,174,336,158,494,816,327,1143,1470,700,2170,1784,1264,3048,1397,1567,2964,426,934,1360,6406,5049,11455
2021-08-26,11,10,21,5,3,8,41,32,73,120,54,174,336,158,494,816,327,1143,1471,700,2171,1784,1264,3048,1397,1567,2964,426,935,1361,6407,5050,11457
2021-08-27,11,10,21,5,3,8,41,32,73,120,54,174,336,158,494,816,327,1143,1471,700,2171,1784,1265,3049,1397,1569,2966,426,935,1361,6407,5053,11460
2021-08-28,11,10,21,5,3,8,41,32,73,120,54,174,336,158,494,816,327,1143,1472,700,2172,1785,1265,3050,1397,1569,2966,426,935,1361,6409,5053,11462
2021-08-29,11,10,21,5,3,8,41,32,73,120,54,174,336,158,494,816,327,1143,1472,700,2172,1785,1267,3052,1397,1569,2966,426,935,1361,6409,5055,11464
2021-08-30,11,10,21,5,3,8,41,32,73,120,54,174,336,158,494,816,328,1144,1473,700,2173,1785,1267,3052,1397,1569,2966,426,935,1361,6410,5056,11466
2021-08-31,11,10,21,5,3,8,41,32,73,120,54,174,336,158,494,816,328,1144,1473,702,2175,1785,1267,3052,1398,1569,2967,426,937,1363,6411,5060,11471
2021-09-01,11,10,21,5,3,8,41,32,73,120,55,175,336,158,494,816,328,1144,1473,702,2175,1785,1267,3052,1398,1569,2967,426,938,1364,6411,5062,11473
2021-09-02,11,10,21,5,3,8,41,32,73,120,55,175,336,158,494,816,328,1144,1473,702,2175,1785,1267,3052,1398,1570,2968,426,938,1364,6411,5063,11474
2021-09-03,11,10,21,5,3,8,41,32,73,120,55,175,336,158,494,817,328,1145,1473,702,2175,1785,1267,3052,1399,1570,2969,426,938,1364,6413,5063,11476
2021-09-04,11,10,21,5,3,8,41,32,73,120,55,175,336,159,495,817,328,1145,1473,702,2175,1785,1267,3052,1399,1570,2969,426,938,1364,6413,5064,11477
2021-09-05,11,10,21,5,3,8,41,32,73,120,55,175,337,159,496,817,328,1145,1473,702,2175,1785,1267,3052,1399,1570,2969,426,938,1364,6414,5064,11478
2021-09-06,11,10,21,5,3,8,41,32,73,120,55,175,337,159,496,817,328,1145,1474,702,2176,1785,1267,3052,1399,1570,2969,426,938,1364,6415,5064,11479
2021-09-07,11,10,21,5,3,8,41,32,73,120,55,175,337,159,496,817,328,1145,1474,702,2176,1786,1267,3053,1399,1570,2969,426,938,1364,6416,5064,11480
2021-09-08,11,10,21,5,3,8,41,32,73,120,55,175,337,159,496,817,328,1145,1474,702,2176,1786,1268,3054,1399,1570,2969,426,939,1365,6416,5066,11482
2021-09-09,11,10,21,5,3,8,41,32,73,120,55,175,337,159,496,817,328,1145,1474,702,2176,1787,1268,3055,1400,1570,2970,426,939,1365,6418,5066,11484
2021-09-10,11,10,21,5,3,8,41,32,73,120,55,175,337,159,496,817,328,1145,1474,702,2176,1787,1268,3055,1400,1570,2970,426,939,1365,6418,5066,11484
2021-09-11,11,10,21,5,3,8,41,32,73,120,55,175,337,159,496,817,328,1145,1474,702,2176,1787,1268,3055,1400,1570,2970,426,939,1365,6418,5066,11484
2021-09-12,11,10,21,5,3,8,41,32,73,120,55,175,337,159,496,817,328,1145,1474,702,2176,1787,1268,3055,1400,1570,2970,426,939,1365,6418,5066,11484
2021-09-13,11,10,21,5,3,8,41,32,73,120,55,175,337,159,496,817,328,1145,1474,702,2176,1787,1268,3055,1400,1571,2971,426,939,1365,6418,5067,11485
2021-09-14,11,10,21,5,3,8,41,32,73,120,55,175,337,159,496,817,328,1145,1474,702,2176,1788,1268,3056,1400,1571,2971,426,939,1365,6419,5067,11486
2021-09-15,11,10,21,5,3,8,41,32,73,121,55,176,337,159,496,817,328,1145,1474,702,2176,1788,1268,3056,1400,1571,2971,426,939,1365,6420,5067,11487
2021-09-16,11,10,21,5,3,8,41,32,73,121,55,176,337,159,496,817,328,1145,1474,702,2176,1788,1269,3057,1400,1571,2971,426,939,1365,6420,5068,11488
2021-09-17,11,10,21,5,3,8,41,32,73,121,55,176,337,159,496,817,328,1145,1474,702,2176,1788,1269,3057,1400,1571,2971,426,939,1365,6420,5068,11488
2021-09-18,11,10,21,5,3,8,41,32,73,121,55,176,337,159,496,817,328,1145,1474,702,2176,1788,1269,3057,1400,1571,2971,426,939,1365,6420,5068,11488
2021-09-19,11,10,21,5,3,8,41,32,73,121,55,176,337,159,496,817,328,1145,1474,702,2176,1788,1270,3058,1400,1571,2971,426,939,1365,6420,5069,11489
2021-09-20,11,10,21,5,3,8,41,32,73,121,55,176,337,159,496,817,328,1145,1474,702,2176,1788,1270,3058,1400,1571,2971,426,939,1365,6420,5069,11489
2021-09-21,11,10,21,5,3,8,41,32,73,121,55,176,337,159,496,817,328,1145,1474,702,2176,1788,1270,3058,1400,1571,2971,426,939,1365,6420,5069,11489
2021-09-22,11,10,21,5,3,8,41,32,73,121,55,176,337,159,496,817,328,1145,1474,702,2176,1788,1270,3058,1400,1571,2971,426,939,1365,6420,5069,11489
2021-09-23,11,10,21,5,3,8,41,32,73,121,55,176,337,159,496,817,328,1145,1475,702,2177,1788,1270,3058,1400,1571,2971,426,939,1365,6421,5069,11490
2021-09-24,11,10,21,5,3,8,41,32,73,121,55,176,337,159,496,817,328,1145,1475,702,2177,1788,1270,3058,1401,1571,2972,426,939,1365,6422,5069,11491
2021-09-25,11,10,21,5,3,8,41,32,73,121,55,176,337,159,496,817,328,1145,1475,702,2177,1789,1270,3059,1401,1571,2972,426,939,1365,6423,5069,11492
2021-09-26,11,10,21,5,3,8,41,32,73,121,55,176,337,159,496,817,328,1145,1475,702,2177,1789,1270,3059,1401,1571,2972,426,939,1365,6423,5069,11492
2021-09-27,11,10,21,5,3,8,41,32,73,121,55,176,337,159,496,817,328,1145,1475,702,2177,1789,1270,3059,1401,1571,2972,426,939,1365,6423,5069,11492
2021-09-28,11,10,21,5,3,8,41,32,73,121,55,176,337,159,496,817,328,1145,1475,702,2177,1789,1270,3059,1401,1571,2972,426,939,1365,6423,5069,11492
2021-09-29,11,10,21,5,3,8,41,32,73,121,55,176,337,159,496,817,328,1145,1475,702,2177,1789,1270,3059,1401,1571,2972,426,939,1365,6423,5069,11492
2021-09-30,11,10,21,5,3,8,41,32,73,121,55,176,337,159,496,817,328,1145,1475,702,2177,1789,1270,3059,1401,1571,2972,426,939,1365,6423,5069,11492
2021-10-01,11,10,21,5,3,8,41,32,73,121,55,176,337,159,496,817,328,1145,1475,702,2177,1789,1271,3060,1401,1571,2972,426,939,1365,6423,5070,11493
2021-10-02,11,10,21,5,3,8,41,32,73,121,55,176,337,159,496,817,328,1145,1475,702,2177,1789,1271,3060,1401,1571,2972,426,939,1365,6423,5070,11493
2021-10-03,11,10,21,5,3,8,41,32,73,121,55,176,337,159,496,817,328,1145,1476,702,2178,1789,1271,3060,1401,1571,2972,426,939,1365,6424,5070,11494
2021-10-04,11,10,21,5,3,8,41,32,73,121,56,177,337,159,496,817,328,1145,1476,702,2178,1789,1271,3060,1401,1571,2972,426,939,1365,6424,5071,11495
2021-10-05,11,10,21,5,3,8,41,32,73,121,56,177,337,159,496,817,329,1146,1476,702,2178,1789,1271,3060,1401,1571,2972,426,939,1365,6424,5072,11496
2021-10-06,11,10,21,5,3,8,41,32,73,121,56,177,337,159,496,817,329,1146,1476,702,2178,1789,1272,3061,1401,1571,2972,426,939,1365,6424,5073,11497
2021-10-07,11,10,21,5,3,8,41,32,73,121,56,177,337,159,496,817,329,1146,1476,702,2178,1789,1272,3061,1401,1571,2972,426,939,1365,6424,5073,11497
2021-10-08,11,10,21,5,3,8,41,32,73,121,56,177,337,159,496,817,329,1146,1476,702,2178,1789,1272,3061,1402,1571,2973,426,939,1365,6425,5073,11498
2021-10-09,11,10,21,5,3,8,41,32,73,121,56,177,337,159,496,817,329,1146,1476,702,2178,1789,1272,3061,1402,1571,2973,426,939,1365,6425,5073,11498
2021-10-10,11,10,21,5,3,8,41,32,73,121,56,177,337,159,496,817,329,1146,1476,702,2178,1789,1272,3061,1402,1571,2973,426,939,1365,6425,5073,11498
2021-10-11,11,10,21,5,3,8,41,32,73,121,56,177,337,159,496,817,329,1146,1476,702,2178,1789,1272,3061,1402,1571,2973,426,939,1365,6425,5073,11498
2021-10-12,11,10,21,5,3,8,41,32,73,121,56,177,337,159,496,817,329,1146,1476,702,2178,1789,1272,3061,1402,1571,2973,426,939,1365,6425,5073,11498
2021-10-13,11,10,21,5,3,8,41,32,73,121,56,177,337,159,496,817,329,1146,1476,702,2178,1789,1273,3062,1402,1571,2973,426,939,1365,6425,5074,11499
2021-10-14,11,10,21,5,3,8,41,32,73,121,56,177,337,159,496,818,329,1147,1477,702,2179,1789,1273,3062,1402,1571,2973,426,939,1365,6427,5074,11501
2021-10-15,11,10,21,5,3,8,41,32,73,121,56,177,337,159,496,818,329,1147,1477,702,2179,1791,1273,3064,1402,1571,2973,426,939,1365,6429,5074,11503
2021-10-16,11,10,21,5,3,8,41,32,73,121,56,177,337,159,496,818,329,1147,1477,702,2179,1791,1273,3064,1404,1571,2975,426,939,1365,6431,5074,11505
2021-10-17,11,10,21,5,3,8,41,32,73,121,56,177,337,159,496,818,329,1147,1477,702,2179,1791,1273,3064,1404,1571,2975,426,939,1365,6431,5074,11505
2021-10-18,11,10,21,5,3,8,41,32,73,121,56,177,337,159,496,818,329,1147,1477,702,2179,1791,1273,3064,1404,1571,2975,426,939,1365,6431,5074,11505
2021-10-19,11,10,21,5,3,8,41,32,73,121,56,177,337,159,496,818,329,1147,1477,702,2179,1791,1273,3064,1404,1571,2975,427,939,1366,6432,5074,11506
2021-10-20,11,10,21,5,3,8,41,32,73,121,56,177,337,159,496,818,329,1147,1477,702,2179,1791,1273,3064,1404,1571,2975,427,939,1366,6432,5074,11506
2021-10-21,11,10,21,5,3,8,41,32,73,121,56,177,337,159,496,818,329,1147,1477,702,2179,1791,1273,3064,1404,1571,2975,427,939,1366,6432,5074,11506
2021-10-22,11,10,21,5,3,8,41,32,73,121,56,177,337,159,496,818,329,1147,1477,702,2179,1791,1273,3064,1404,1571,2975,428,939,1367,6433,5074,11507
2021-10-23,11,10,21,5,3,8,41,32,73,121,56,177,337,159,496,819,329,1148,1477,702,2179,1791,1273,3064,1404,1571,2975,428,939,1367,6434,5074,11508
2021-10-24,11,10,21,5,3,8,41,32,73,121,56,177,337,159,496,819,329,1148,1477,702,2179,1791,1273,3064,1404,1571,2975,428,939,1367,6434,5074,11508
2021-10-25,11,10,21,5,3,8,41,32,73,121,56,177,337,159,496,820,330,1150,1477,702,2179,1791,1273,3064,1404,1572,2976,428,939,1367,6435,5076,11511
2021-10-26,11,10,21,5,3,8,41,32,73,121,56,177,337,159,496,820,330,1150,1477,702,2179,1791,1273,3064,1404,1572,2976,428,939,1367,6435,5076,11511
2021-10-27,11,10,21,5,3,8,41,32,73,121,56,177,337,159,496,820,330,1150,1477,702,2179,1791,1274,3065,1404,1572,2976,428,939,1367,6435,5077,11512
2021-10-28,11,10,21,5,3,8,41,32,73,121,56,177,337,159,496,820,330,1150,1477,702,2179,1791,1274,3065,1404,1573,2977,428,939,1367,6435,5078,11513
2021-10-29,11,10,21,5,3,8,41,32,73,121,56,177,337,159,496,820,330,1150,1477,702,2179,1791,1274,3065,1404,1573,2977,428,939,1367,6435,5078,11513
2021-10-30,11,10,21,5,3,8,41,32,73,121,56,177,337,159,496,820,330,1150,1477,702,2179,1791,1274,3065,1404,1573,2977,428,939,1367,6435,5078,11513
2021-10-31,11,10,21,5,3,8,41,32,73,121,56,177,337,159,496,820,330,1150,1477,702,2179,1791,1274,3065,1404,1573,2977,428,940,1368,6435,5079,11514
2021-11-01,11,10,21,5,3,8,41,32,73,121,56,177,337,159,496,820,330,1150,1477,702,2179,1791,1274,3065,1404,1573,2977,428,940,1368,6435,5079,11514
2021-11-02,11,10,21,5,3,8,41,32,73,121,56,177,337,159,496,820,330,1150,1477,702,2179,1791,1274,3065,1404,1573,2977,428,940,1368,6435,5079,11514
2021-11-03,11,10,21,5,3,8,41,32,73,121,56,177,337,159,496,820,330,1150,1477,702,2179,1791,1274,3065,1404,1573,2977,428,940,1368,6435,5079,11514
2021-11-04,11,10,21,5,3,8,41,32,73,121,56,177,337,159,496,820,330,1150,1477,702,2179,1791,1274,3065,1404,1573,2977,428,940,1368,6435,5079,11514
2021-11-05,11,10,21,5,3,8,41,32,73,121,56,177,337,159,496,820,330,1150,1477,702,2179,1791,1274,3065,1404,1573,2977,428,940,1368,6435,5079,11514
2021-11-06,11,10,21,5,3,8,41,32,73,121,56,177,337,159,496,820,330,1150,1477,702,2179,1791,1274,3065,1404,1573,2977,428,940,1368,6435,5079,11514
2021-11-07,11,10,21,5,3,8,41,32,73,121,56,177,337,159,496,820,330,1150,1477,702,2179,1791,1274,3065,1404,1573,2977,428,940,1368,6435,5079,11514
2021-11-08,11,10,21,5,3,8,41,32,73,121,56,177,337,159,496,820,330,1150,1477,702,2179,1791,1274,3065,1404,1574,2978,428,940,1368,6435,5080,11515
2021-11-09,11,10,21,5,3,8,41,32,73,121,56,177,337,159,496,820,330,1150,1477,702,2179,1791,1274,3065,1404,1574,2978,428,940,1368,6435,5080,11515
2021-11-10,11,10,21,5,3,8,41,32,73,121,56,177,337,159,496,820,330,1150,1477,702,2179,1791,1274,3065,1404,1574,2978,428,940,1368,6435,5080,11515
2021-11-11,11,10,21,5,3,8,41,32,73,121,56,177,337,159,496,820,330,1150,1477,702,2179,1791,1274,3065,1404,1574,2978,428,940,1368,6435,5080,11515
2021-11-12,11,10,21,5,3,8,41,32,73,121,56,177,337,159,496,820,330,1150,1477,702,2179,1791,1274,3065,1404,1574,2978,428,940,1368,6435,5080,11515
2021-11-13,11,10,21,5,3,8,41,32,73,121,56,177,337,159,496,820,330,1150,1477,702,2179,1791,1274,3065,1404,1574,2978,428,940,1368,6435,5080,11515
2021-11-14,11,10,21,5,3,8,41,32,73,121,56,177,337,159,496,820,330,1150,1477,702,2179,1791,1274,3065,1404,1574,2978,428,940,1368,6435,5080,11515
2021-11-15,11,10,21,5,3,8,41,32,73,121,56,177,337,159,496,820,330,1150,1477,702,2179,1791,1274,3065,1404,1574,2978,428,940,1368,6435,5080,11515
2021-11-16,11,10,21,5,3,8,41,32,73,121,56,177,337,159,496,820,330,1150,1477,702,2179,1791,1274,3065,1404,1574,2978,428,940,1368,6435,5080,11515
2021-11-17,11,10,21,5,3,8,41,32,73,121,56,177,337,159,496,820,330,1150,1477,702,2179,1791,1274,3065,1405,1574,2979,428,940,1368,6436,5080,11516
2021-11-18,11,10,21,5,3,8,41,32,73,121,56,177,337,159,496,820,330,1150,1477,702,2179,1791,1274,3065,1405,1574,2979,428,940,1368,6436,5080,11516
2021-11-19,11,10,21,5,3,8,41,32,73,121,56,177,337,159,496,820,330,1150,1477,702,2179,1791,1274,3065,1405,1574,2979,428,940,1368,6436,5080,11516
2021-11-20,11,10,21,5,3,8,41,32,73,121,56,177,337,159,496,820,330,1150,1477,702,2179,1791,1274,3065,1405,1574,2979,428,940,1368,6436,5080,11516
2021-11-21,11,10,21,5,3,8,41,32,73,121,56,177,337,159,496,820,330,1150,1477,702,2179,1791,1274,3065,1405,1574,2979,428,940,1368,6436,5080,11516
2021-11-22,11,10,21,5,3,8,41,32,73,121,56,177,337,159,496,820,330,1150,1477,702,2179,1791,1274,3065,1405,1574,2979,428,940,1368,6436,5080,11516
