FECHA,<=10M,<=10F,<=10,11-20M,11-20F,11-20,21-30M,21-30F,21-30,31-40M,31-40F,31-40,41-50M,41-50F,41-50,51-60M,51-60F,51-60,61-70M,61-70F,61-70,71-80M,71-80F,71-80,81-90M,81-90F,81-90,>=91M,>=91F,>=91,TotalM,TotalF,Total
2020-03-15,0,0,0,0,0,0,0,0,0,0,0,0,0,0,0,0,0,0,0,0,0,0,0,0,0,0,0,0,0,0,0,0,0
2020-03-16,0,0,0,0,0,0,0,0,0,0,0,0,0,0,0,0,0,0,0,0,0,0,0,0,0,0,0,0,0,0,0,0,0
2020-03-17,0,0,0,0,0,0,0,0,0,0,0,0,0,0,0,0,0,0,0,0,0,1,0,1,0,0,0,0,0,0,1,0,1
2020-03-18,0,0,0,0,0,0,0,0,0,0,0,0,0,0,0,0,0,0,0,0,0,1,0,1,0,0,0,0,0,0,1,0,1
2020-03-19,0,0,0,0,0,0,0,0,0,0,0,0,0,0,0,0,0,0,0,0,0,1,0,1,0,0,0,0,0,0,1,0,1
2020-03-20,0,0,0,0,0,0,0,0,0,0,0,0,0,0,0,0,0,0,0,0,0,1,0,1,0,1,1,0,0,0,1,1,2
2020-03-21,0,0,0,0,0,0,0,0,0,0,0,0,0,0,0,0,0,0,1,0,1,2,0,2,1,1,2,0,0,0,4,1,5
2020-03-22,0,0,0,0,0,0,0,0,0,0,0,0,0,0,0,0,0,0,1,0,1,3,0,3,1,1,2,0,0,0,5,1,6
2020-03-23,0,0,0,0,0,0,0,0,0,0,0,0,0,0,0,0,0,0,1,0,1,3,0,3,1,1,2,0,0,0,5,1,6
2020-03-24,0,0,0,0,0,0,0,0,0,0,0,0,0,0,0,0,0,0,1,0,1,3,1,4,1,1,2,0,0,0,5,2,7
2020-03-25,0,0,0,0,0,0,0,0,0,0,0,0,0,0,0,0,0,0,2,0,2,3,1,4,2,3,5,0,1,1,7,5,12
2020-03-26,0,0,0,0,0,0,0,0,0,0,0,0,0,0,0,1,0,1,3,0,3,4,1,5,2,3,5,0,1,1,10,5,15
2020-03-27,0,0,0,0,0,0,0,0,0,0,0,0,0,0,0,2,0,2,4,0,4,4,1,5,2,3,5,0,1,1,12,5,17
2020-03-28,0,0,0,0,0,0,0,0,0,0,0,0,0,0,0,2,0,2,4,0,4,4,1,5,4,3,7,0,1,1,14,5,19
2020-03-29,0,0,0,0,0,0,0,0,0,0,0,0,0,0,0,2,0,2,4,0,4,4,1,5,4,3,7,0,1,1,14,5,19
2020-03-30,0,0,0,0,0,0,0,0,0,0,0,0,1,0,1,2,0,2,5,0,5,6,1,7,4,3,7,0,2,2,18,6,24
2020-03-31,0,0,0,0,0,0,0,0,0,0,0,0,1,0,1,2,0,2,6,0,6,8,2,10,4,4,8,0,2,2,21,8,29
2020-04-01,0,0,0,0,0,0,0,0,0,0,0,0,1,0,1,2,0,2,8,0,8,8,2,10,4,4,8,0,2,2,23,8,31
2020-04-02,0,0,0,0,0,0,0,0,0,0,0,0,1,0,1,2,0,2,8,0,8,10,2,12,4,4,8,1,3,4,26,9,35
2020-04-03,0,0,0,0,0,0,0,0,0,0,0,0,1,0,1,2,1,3,8,1,9,11,2,13,4,5,9,1,3,4,27,12,39
2020-04-04,0,0,0,0,0,0,0,0,0,0,0,0,1,0,1,2,1,3,8,1,9,11,2,13,4,5,9,2,3,5,28,12,40
2020-04-05,0,0,0,0,0,0,0,0,0,0,0,0,1,1,2,2,1,3,8,1,9,13,2,15,4,5,9,2,3,5,30,13,43
2020-04-06,0,0,0,0,0,0,0,0,0,0,0,0,1,1,2,2,1,3,9,1,10,13,3,16,4,5,9,2,3,5,31,14,45
2020-04-07,0,0,0,0,0,0,0,0,0,0,0,0,1,1,2,2,1,3,9,1,10,13,5,18,4,5,9,3,3,6,32,16,48
2020-04-08,0,0,0,0,0,0,0,0,0,0,0,0,1,1,2,3,1,4,9,1,10,14,5,19,4,6,10,3,3,6,34,17,51
2020-04-09,0,0,0,0,0,0,0,0,0,0,0,0,1,1,2,3,1,4,9,1,10,14,5,19,4,6,10,3,3,6,34,17,51
2020-04-10,0,0,0,0,0,0,0,0,0,0,0,0,1,1,2,3,1,4,9,1,10,14,5,19,4,6,10,3,3,6,34,17,51
2020-04-11,0,0,0,0,0,0,0,0,0,0,0,0,1,1,2,3,1,4,9,1,10,14,5,19,6,6,12,3,3,6,36,17,53
2020-04-12,0,0,0,0,0,0,0,0,0,0,0,0,1,1,2,3,1,4,9,1,10,14,5,19,6,6,12,3,3,6,36,17,53
2020-04-13,0,0,0,0,0,0,0,0,0,0,0,0,1,1,2,3,1,4,9,1,10,14,5,19,6,6,12,3,3,6,36,17,53
2020-04-14,0,0,0,0,0,0,0,0,0,0,0,0,1,1,2,3,1,4,9,1,10,17,5,22,6,7,13,3,3,6,39,18,57
2020-04-15,0,0,0,0,0,0,0,0,0,0,0,0,1,1,2,3,1,4,9,1,10,17,5,22,6,7,13,3,3,6,39,18,57
2020-04-16,0,0,0,0,0,0,0,0,0,0,0,0,1,1,2,3,1,4,9,1,10,17,5,22,6,7,13,3,3,6,39,18,57
2020-04-17,0,0,0,0,0,0,1,0,1,0,0,0,1,1,2,3,1,4,9,1,10,17,6,23,8,9,17,3,5,8,42,23,65
2020-04-18,0,0,0,0,0,0,1,0,1,0,0,0,2,1,3,3,1,4,9,1,10,17,7,24,9,11,20,3,7,10,44,28,72
2020-04-19,0,0,0,0,0,0,1,0,1,0,0,0,2,1,3,3,1,4,9,1,10,17,7,24,9,11,20,4,7,11,45,28,73
2020-04-20,0,0,0,0,0,0,1,0,1,0,0,0,3,1,4,3,1,4,9,1,10,17,7,24,10,11,21,4,8,12,47,29,76
2020-04-21,0,0,0,0,0,0,1,0,1,0,0,0,3,1,4,4,1,5,10,1,11,17,7,24,12,11,23,5,11,16,52,32,84
2020-04-22,0,0,0,0,0,0,1,0,1,1,0,1,3,1,4,4,1,5,11,2,13,18,10,28,13,13,26,6,13,19,57,40,97
2020-04-23,0,0,0,0,0,0,1,0,1,1,0,1,3,1,4,4,1,5,12,3,15,20,12,32,16,13,29,6,16,22,63,46,109
2020-04-24,0,0,0,0,0,0,1,0,1,1,0,1,3,1,4,4,1,5,12,3,15,20,12,32,18,15,33,6,16,22,65,48,113
2020-04-25,0,0,0,0,0,0,1,0,1,1,0,1,3,1,4,5,1,6,12,3,15,20,12,32,18,17,35,6,16,22,66,50,116
2020-04-26,0,0,0,0,0,0,1,0,1,1,0,1,3,1,4,5,1,6,12,3,15,20,12,32,18,17,35,6,16,22,66,50,116
2020-04-27,0,0,0,0,0,0,1,0,1,1,0,1,3,1,4,5,1,6,13,3,16,21,12,33,20,18,38,7,17,24,71,52,123
2020-04-28,0,0,0,0,0,0,1,0,1,1,0,1,3,1,4,5,1,6,13,3,16,21,12,33,21,20,41,7,17,24,72,54,126
2020-04-29,0,0,0,0,0,0,1,0,1,1,0,1,3,1,4,5,1,6,13,3,16,22,12,34,21,20,41,7,17,24,73,54,127
2020-04-30,0,0,0,0,0,0,1,0,1,1,0,1,3,1,4,6,1,7,13,3,16,22,12,34,21,20,41,7,17,24,74,54,128
2020-05-01,0,0,0,0,0,0,1,0,1,1,0,1,3,1,4,6,1,7,14,3,17,22,12,34,21,21,42,8,17,25,76,55,131
2020-05-02,0,0,0,0,0,0,1,0,1,1,0,1,3,1,4,6,1,7,14,3,17,23,12,35,21,21,42,8,17,25,77,55,132
2020-05-03,0,0,0,0,0,0,1,0,1,1,0,1,3,1,4,7,1,8,15,3,18,23,12,35,22,21,43,8,17,25,80,55,135
2020-05-04,0,0,0,0,0,0,1,0,1,1,0,1,3,1,4,8,1,9,15,3,18,23,12,35,22,23,45,8,17,25,81,57,138
2020-05-05,0,0,0,0,0,0,1,0,1,1,0,1,4,2,6,8,1,9,15,3,18,24,12,36,25,23,48,8,19,27,86,60,146
2020-05-06,0,0,0,0,0,0,1,0,1,1,0,1,5,2,7,8,1,9,16,4,20,25,12,37,25,23,48,10,21,31,91,63,154
2020-05-07,0,0,0,0,0,0,1,0,1,1,0,1,5,2,7,10,1,11,16,4,20,25,13,38,26,23,49,10,23,33,94,66,160
2020-05-08,0,0,0,0,0,0,1,0,1,1,0,1,5,2,7,10,1,11,16,4,20,25,13,38,26,24,50,10,23,33,94,67,161
2020-05-09,0,0,0,0,0,0,1,0,1,1,0,1,5,2,7,10,1,11,16,5,21,25,13,38,26,24,50,11,23,34,95,68,163
2020-05-10,0,0,0,0,0,0,1,0,1,1,0,1,5,2,7,10,1,11,17,5,22,25,13,38,26,24,50,11,23,34,96,68,164
2020-05-11,0,0,0,0,0,0,1,0,1,1,0,1,6,3,9,10,1,11,18,5,23,25,13,38,26,24,50,11,23,34,98,69,167
2020-05-12,0,0,0,0,0,0,1,0,1,1,0,1,7,3,10,12,2,14,19,6,25,27,16,43,26,25,51,12,24,36,105,76,181
2020-05-13,0,0,0,0,0,0,1,0,1,1,0,1,8,3,11,12,3,15,21,6,27,27,16,43,26,25,51,12,27,39,108,80,188
2020-05-14,0,0,0,0,0,0,1,0,1,1,0,1,8,3,11,14,3,17,22,6,28,28,18,46,26,25,51,12,27,39,112,82,194
2020-05-15,0,0,0,0,0,0,1,0,1,1,0,1,8,4,12,14,3,17,22,6,28,28,19,47,26,26,52,13,28,41,113,86,199
2020-05-16,0,0,0,0,0,0,1,0,1,2,0,2,8,5,13,14,3,17,23,7,30,30,20,50,26,27,53,13,31,44,117,93,210
2020-05-17,0,1,1,0,0,0,1,0,1,2,0,2,8,6,14,17,3,20,24,7,31,31,20,51,27,30,57,14,31,45,124,98,222
2020-05-18,0,1,1,0,0,0,1,0,1,3,0,3,8,6,14,20,3,23,26,8,34,32,21,53,28,30,58,14,31,45,132,100,232
2020-05-19,0,1,1,0,0,0,1,0,1,3,0,3,9,6,15,21,3,24,26,8,34,32,21,53,28,32,60,15,31,46,135,102,237
2020-05-20,0,1,1,0,0,0,1,1,2,4,0,4,9,7,16,24,4,28,27,8,35,33,22,55,29,34,63,16,31,47,143,108,251
2020-05-21,0,1,1,0,0,0,1,1,2,4,0,4,10,7,17,24,4,28,29,8,37,33,23,56,29,35,64,16,34,50,146,113,259
2020-05-22,0,1,1,0,0,0,1,1,2,4,0,4,10,7,17,27,4,31,30,9,39,33,24,57,29,35,64,16,34,50,150,115,265
2020-05-23,0,1,1,0,0,0,1,1,2,4,0,4,13,7,20,28,4,32,31,9,40,34,24,58,31,38,69,16,36,52,158,120,278
2020-05-24,0,1,1,0,0,0,1,1,2,5,0,5,13,7,20,28,5,33,32,9,41,34,25,59,31,38,69,17,36,53,161,122,283
2020-05-25,0,1,1,0,0,0,1,1,2,5,0,5,13,8,21,29,5,34,33,11,44,35,29,64,32,39,71,18,36,54,166,130,296
2020-05-26,0,1,1,0,0,0,1,1,2,5,0,5,13,9,22,32,6,38,36,13,49,36,30,66,32,42,74,20,36,56,175,138,313
2020-05-27,0,1,1,0,0,0,1,1,2,5,0,5,15,10,25,32,6,38,37,13,50,39,33,72,33,44,77,20,37,57,182,145,327
2020-05-28,0,1,1,0,0,0,1,1,2,6,0,6,16,11,27,34,7,41,38,14,52,40,39,79,37,48,85,23,46,69,195,167,362
2020-05-29,0,1,1,0,0,0,1,1,2,6,0,6,17,12,29,35,7,42,39,14,53,43,41,84,39,54,93,23,49,72,203,179,382
2020-05-30,0,1,1,0,0,0,1,1,2,6,0,6,18,12,30,38,7,45,39,14,53,45,42,87,40,54,94,24,49,73,211,180,391
2020-05-31,0,1,1,0,0,0,1,1,2,6,0,6,18,12,30,40,9,49,39,14,53,49,43,92,43,55,98,25,50,75,221,185,406
2020-06-01,0,1,1,0,0,0,1,1,2,7,0,7,18,13,31,41,9,50,40,14,54,50,45,95,45,57,102,26,50,76,228,190,418
2020-06-02,1,1,2,0,0,0,1,1,2,7,0,7,19,15,34,42,10,52,46,14,60,52,47,99,46,59,105,28,53,81,242,200,442
2020-06-03,1,1,2,0,0,0,1,1,2,7,0,7,19,16,35,46,11,57,51,15,66,55,48,103,47,60,107,28,53,81,255,205,460
2020-06-04,1,1,2,0,0,0,1,1,2,8,0,8,19,16,35,47,12,59,54,16,70,57,50,107,48,63,111,31,57,88,266,216,482
2020-06-05,1,1,2,0,0,0,1,2,3,8,0,8,19,16,35,48,13,61,58,17,75,62,55,117,50,67,117,31,59,90,278,230,508
2020-06-06,1,1,2,0,0,0,1,2,3,8,0,8,19,16,35,51,13,64,58,17,75,64,57,121,52,73,125,31,62,93,285,241,526
2020-06-07,1,1,2,0,0,0,1,2,3,8,0,8,19,16,35,53,13,66,59,17,76,64,59,123,55,77,132,31,65,96,291,250,541
2020-06-08,1,1,2,0,0,0,1,2,3,10,0,10,21,16,37,54,13,67,59,18,77,69,61,130,60,78,138,31,68,99,306,257,563
2020-06-09,1,1,2,0,0,0,1,2,3,10,1,11,22,17,39,56,13,69,59,21,80,71,61,132,62,80,142,31,71,102,313,267,580
2020-06-10,1,1,2,0,0,0,1,2,3,10,1,11,22,18,40,57,14,71,62,22,84,75,62,137,63,88,151,32,74,106,323,282,605
2020-06-11,1,1,2,0,0,0,1,2,3,10,1,11,24,18,42,61,14,75,65,23,88,77,66,143,64,91,155,32,77,109,335,293,628
2020-06-12,1,1,2,0,0,0,1,2,3,11,1,12,24,18,42,65,15,80,67,25,92,84,67,151,67,91,158,33,79,112,353,299,652
2020-06-13,1,1,2,0,0,0,1,3,4,11,2,13,24,20,44,67,16,83,70,25,95,86,71,157,69,95,164,33,84,117,362,317,679
2020-06-14,1,1,2,0,0,0,1,3,4,11,2,13,25,20,45,67,17,84,73,25,98,88,72,160,70,96,166,34,89,123,370,325,695
2020-06-15,1,1,2,0,0,0,1,3,4,11,2,13,25,21,46,67,17,84,76,25,101,88,77,165,70,97,167,37,89,126,376,332,708
2020-06-16,1,1,2,0,0,0,2,3,5,12,2,14,26,21,47,69,17,86,80,28,108,96,78,174,72,99,171,37,92,129,395,341,736
2020-06-17,2,1,3,0,0,0,3,3,6,12,2,14,27,21,48,69,20,89,85,29,114,103,80,183,75,101,176,38,97,135,414,354,768
2020-06-18,2,1,3,0,0,0,3,3,6,14,2,16,29,22,51,73,21,94,86,30,116,105,82,187,80,102,182,39,98,137,431,361,792
2020-06-19,2,1,3,0,0,0,3,3,6,15,2,17,29,22,51,75,23,98,89,33,122,110,87,197,87,102,189,39,107,146,449,380,829
2020-06-20,2,1,3,0,0,0,3,3,6,16,2,18,29,22,51,76,24,100,90,35,125,117,91,208,90,107,197,41,110,151,464,395,859
2020-06-21,2,1,3,0,0,0,3,3,6,16,3,19,30,23,53,77,24,101,94,35,129,119,94,213,92,111,203,41,115,156,474,409,883
2020-06-22,2,1,3,0,0,0,3,4,7,17,3,20,32,23,55,77,25,102,99,39,138,125,97,222,98,118,216,44,116,160,497,426,923
2020-06-23,2,1,3,0,0,0,3,4,7,17,3,20,34,23,57,81,26,107,100,41,141,131,98,229,106,124,230,47,121,168,521,441,962
2020-06-24,2,1,3,0,0,0,3,4,7,17,3,20,34,25,59,83,27,110,102,42,144,135,100,235,112,128,240,49,127,176,537,457,994
2020-06-25,2,1,3,0,0,0,3,4,7,17,3,20,36,25,61,86,28,114,108,44,152,138,105,243,117,136,253,50,131,181,557,477,1034
2020-06-26,2,1,3,0,0,0,3,4,7,17,3,20,36,27,63,89,29,118,111,44,155,144,107,251,119,140,259,51,134,185,572,489,1061
2020-06-27,2,1,3,0,0,0,3,4,7,17,3,20,37,27,64,90,30,120,115,46,161,145,109,254,122,143,265,53,137,190,584,500,1084
2020-06-28,2,1,3,0,0,0,3,4,7,17,3,20,37,27,64,90,30,120,115,47,162,147,111,258,127,148,275,54,143,197,592,514,1106
2020-06-29,2,1,3,0,0,0,3,5,8,17,3,20,37,28,65,92,30,122,118,49,167,151,114,265,136,156,292,55,147,202,611,533,1144
2020-06-30,2,1,3,0,0,0,3,5,8,17,3,20,38,29,67,96,33,129,126,52,178,159,118,277,141,164,305,57,156,213,639,561,1200
2020-07-01,2,1,3,0,0,0,3,5,8,17,3,20,38,30,68,99,34,133,129,52,181,162,120,282,152,168,320,60,159,219,662,572,1234
2020-07-02,2,1,3,0,0,0,3,5,8,17,4,21,39,30,69,102,34,136,135,53,188,168,124,292,156,172,328,60,162,222,682,585,1267
2020-07-03,2,1,3,0,0,0,3,5,8,17,4,21,40,32,72,104,34,138,140,53,193,174,130,304,157,182,339,62,165,227,699,606,1305
2020-07-04,2,1,3,0,1,1,3,5,8,17,5,22,41,33,74,105,35,140,141,55,196,179,137,316,161,192,353,63,174,237,712,638,1350
2020-07-05,2,2,4,0,1,1,3,5,8,18,6,24,41,33,74,108,36,144,145,60,205,181,140,321,165,202,367,66,179,245,729,664,1393
2020-07-06,2,2,4,0,1,1,3,5,8,18,6,24,43,33,76,110,37,147,152,63,215,190,146,336,175,217,392,71,189,260,764,699,1463
2020-07-07,2,2,4,0,1,1,3,5,8,19,6,25,43,33,76,112,37,149,162,64,226,200,152,352,184,223,407,75,197,272,800,720,1520
2020-07-08,2,2,4,0,1,1,3,5,8,19,6,25,44,34,78,114,39,153,168,66,234,207,160,367,190,226,416,79,205,284,826,744,1570
2020-07-09,2,2,4,0,1,1,3,6,9,19,6,25,45,35,80,114,40,154,171,67,238,215,164,379,194,235,429,82,209,291,845,765,1610
2020-07-10,2,2,4,0,1,1,3,7,10,20,6,26,45,35,80,115,43,158,178,69,247,221,172,393,205,244,449,83,215,298,872,794,1666
2020-07-11,2,2,4,0,1,1,3,8,11,22,6,28,45,35,80,116,43,159,182,69,251,226,174,400,206,252,458,84,222,306,886,812,1698
2020-07-12,2,2,4,0,1,1,4,8,12,22,7,29,49,35,84,118,43,161,185,69,254,231,178,409,216,258,474,87,229,316,914,830,1744
2020-07-13,2,2,4,0,1,1,4,8,12,22,7,29,49,36,85,118,44,162,192,71,263,238,186,424,222,264,486,91,242,333,938,861,1799
2020-07-14,2,2,4,0,1,1,4,8,12,22,7,29,50,36,86,121,48,169,198,73,271,253,188,441,227,274,501,96,252,348,973,889,1862
2020-07-15,2,3,5,0,1,1,4,8,12,23,8,31,53,36,89,121,48,169,207,74,281,262,193,455,236,285,521,98,258,356,1006,914,1920
2020-07-16,2,3,5,0,1,1,4,8,12,24,8,32,53,36,89,122,48,170,214,76,290,269,197,466,248,294,542,104,267,371,1040,938,1978
2020-07-17,2,3,5,0,1,1,5,8,13,24,9,33,56,36,92,125,49,174,222,78,300,275,202,477,262,305,567,107,280,387,1078,971,2049
2020-07-18,2,3,5,0,1,1,6,9,15,24,9,33,58,37,95,125,50,175,226,78,304,281,208,489,266,313,579,109,286,395,1097,994,2091
2020-07-19,2,3,5,0,1,1,6,9,15,24,9,33,58,37,95,127,51,178,226,78,304,287,210,497,274,324,598,115,291,406,1119,1013,2132
2020-07-20,2,3,5,0,1,1,6,9,15,25,10,35,60,38,98,129,53,182,232,80,312,294,216,510,283,334,617,118,293,411,1149,1037,2186
2020-07-21,2,3,5,0,1,1,7,9,16,27,10,37,62,38,100,130,54,184,246,83,329,299,221,520,293,346,639,120,304,424,1186,1069,2255
2020-07-22,2,3,5,0,1,1,7,9,16,27,10,37,62,38,100,133,54,187,252,83,335,306,227,533,302,355,657,123,312,435,1214,1092,2306
2020-07-23,2,3,5,0,1,1,7,9,16,27,11,38,63,38,101,136,55,191,258,85,343,310,233,543,310,365,675,123,316,439,1236,1116,2352
2020-07-24,2,3,5,0,1,1,7,9,16,27,11,38,65,38,103,139,56,195,264,88,352,317,236,553,318,380,698,124,321,445,1263,1143,2406
2020-07-25,2,4,6,0,1,1,7,9,16,27,11,38,65,38,103,141,59,200,268,88,356,319,239,558,325,388,713,129,332,461,1283,1169,2452
2020-07-26,2,4,6,0,1,1,8,9,17,28,11,39,67,38,105,141,60,201,270,88,358,325,245,570,335,393,728,131,338,469,1307,1187,2494
2020-07-27,2,4,6,0,1,1,9,9,18,28,12,40,68,39,107,146,63,209,271,90,361,329,251,580,345,398,743,135,342,477,1333,1209,2542
2020-07-28,2,4,6,0,1,1,9,10,19,28,12,40,69,40,109,148,64,212,276,94,370,337,258,595,355,409,764,137,348,485,1361,1240,2601
2020-07-29,2,4,6,0,1,1,9,10,19,29,13,42,69,41,110,151,65,216,281,94,375,341,263,604,359,415,774,141,349,490,1382,1255,2637
2020-07-30,2,4,6,0,1,1,9,10,19,29,13,42,73,44,117,151,65,216,283,95,378,345,266,611,363,425,788,143,354,497,1398,1277,2675
2020-07-31,2,4,6,0,1,1,9,11,20,29,13,42,75,45,120,153,67,220,287,97,384,348,270,618,369,434,803,144,365,509,1416,1307,2723
2020-08-01,2,4,6,0,1,1,9,11,20,29,13,42,77,46,123,155,68,223,289,100,389,353,274,627,373,438,811,147,372,519,1434,1327,2761
2020-08-02,2,4,6,0,1,1,9,11,20,30,13,43,78,46,124,157,69,226,291,102,393,360,280,640,379,450,829,148,377,525,1454,1353,2807
2020-08-03,2,4,6,0,1,1,10,11,21,30,13,43,79,47,126,159,70,229,299,105,404,370,286,656,385,464,849,149,391,540,1483,1392,2875
2020-08-04,2,5,7,0,1,1,10,11,21,30,13,43,80,48,128,162,72,234,305,108,413,378,290,668,395,473,868,152,405,557,1514,1426,2940
2020-08-05,2,6,8,0,1,1,10,11,21,30,13,43,81,49,130,164,75,239,314,111,425,386,293,679,405,490,895,154,413,567,1546,1462,3008
2020-08-06,2,6,8,0,1,1,10,11,21,31,13,44,84,49,133,167,76,243,318,113,431,390,299,689,411,498,909,159,422,581,1572,1488,3060
2020-08-07,2,6,8,0,1,1,10,11,21,32,13,45,85,51,136,167,76,243,320,115,435,393,304,697,418,503,921,164,425,589,1591,1505,3096
2020-08-08,2,6,8,0,1,1,10,11,21,33,13,46,85,52,137,168,78,246,324,117,441,398,308,706,425,510,935,166,429,595,1611,1525,3136
2020-08-09,2,6,8,0,1,1,10,11,21,33,13,46,85,53,138,170,79,249,333,122,455,403,310,713,430,517,947,170,429,599,1636,1541,3177
2020-08-10,2,6,8,0,1,1,10,11,21,34,13,47,86,53,139,171,84,255,337,125,462,409,313,722,436,527,963,170,434,604,1655,1567,3222
2020-08-11,2,6,8,0,1,1,10,11,21,35,13,48,87,53,140,172,84,256,342,129,471,414,317,731,439,534,973,173,438,611,1674,1586,3260
2020-08-12,3,6,9,0,1,1,10,11,21,35,13,48,88,53,141,173,85,258,343,133,476,418,321,739,443,539,982,175,441,616,1688,1603,3291
2020-08-13,3,6,9,0,1,1,10,11,21,35,13,48,88,53,141,173,87,260,349,136,485,425,323,748,449,545,994,177,443,620,1709,1618,3327
2020-08-14,3,6,9,0,1,1,10,11,21,35,13,48,89,53,142,174,87,261,353,137,490,430,326,756,454,550,1004,177,446,623,1725,1630,3355
2020-08-15,3,6,9,0,1,1,10,12,22,35,13,48,90,53,143,175,87,262,356,139,495,440,330,770,463,562,1025,177,454,631,1749,1657,3406
2020-08-16,3,6,9,0,1,1,10,12,22,35,13,48,90,53,143,177,88,265,359,139,498,444,334,778,470,568,1038,177,460,637,1765,1674,3439
2020-08-17,3,6,9,0,1,1,10,12,22,35,14,49,91,53,144,179,89,268,364,139,503,447,337,784,473,571,1044,177,464,641,1779,1686,3465
2020-08-18,3,6,9,0,1,1,12,12,24,35,14,49,91,53,144,180,90,270,368,140,508,456,339,795,476,589,1065,179,470,649,1800,1714,3514
2020-08-19,3,6,9,0,1,1,12,13,25,36,14,50,92,53,145,182,91,273,378,141,519,458,346,804,487,600,1087,184,472,656,1832,1737,3569
2020-08-20,3,6,9,0,1,1,12,13,25,38,14,52,93,53,146,182,91,273,387,141,528,464,353,817,495,604,1099,187,479,666,1861,1755,3616
2020-08-21,3,6,9,0,1,1,12,14,26,38,14,52,95,53,148,183,91,274,394,141,535,466,358,824,499,614,1113,189,485,674,1879,1777,3656
2020-08-22,3,6,9,0,1,1,12,14,26,38,14,52,96,53,149,184,91,275,400,143,543,470,361,831,505,619,1124,190,487,677,1898,1789,3687
2020-08-23,3,6,9,0,1,1,12,14,26,39,14,53,96,53,149,186,92,278,405,146,551,473,363,836,516,623,1139,195,493,688,1925,1805,3730
2020-08-24,3,6,9,0,1,1,12,14,26,40,14,54,97,53,150,188,92,280,409,150,559,478,368,846,520,627,1147,198,498,696,1945,1823,3768
2020-08-25,3,6,9,0,1,1,12,14,26,42,14,56,98,53,151,192,93,285,411,157,568,484,374,858,533,637,1170,200,502,702,1975,1851,3826
2020-08-26,3,6,9,0,1,1,12,14,26,42,15,57,99,55,154,194,94,288,416,159,575,491,379,870,539,645,1184,202,511,713,1998,1879,3877
2020-08-27,3,6,9,0,1,1,12,14,26,43,15,58,100,56,156,197,94,291,419,161,580,499,379,878,545,656,1201,207,516,723,2025,1898,3923
2020-08-28,3,6,9,0,1,1,12,14,26,43,15,58,101,56,157,201,94,295,422,163,585,508,382,890,548,663,1211,208,517,725,2046,1911,3957
2020-08-29,3,6,9,0,1,1,12,14,26,45,15,60,101,56,157,203,95,298,424,164,588,514,386,900,554,664,1218,209,520,729,2065,1921,3986
2020-08-30,3,6,9,0,1,1,12,14,26,46,15,61,101,56,157,206,96,302,430,164,594,522,390,912,559,668,1227,211,524,735,2090,1934,4024
2020-08-31,3,6,9,0,1,1,12,14,26,46,15,61,102,56,158,207,97,304,439,165,604,536,394,930,567,674,1241,211,525,736,2123,1947,4070
2020-09-01,3,6,9,0,1,1,12,14,26,46,15,61,103,56,159,207,97,304,447,166,613,544,398,942,572,683,1255,214,530,744,2148,1966,4114
2020-09-02,3,6,9,0,1,1,12,14,26,46,15,61,103,56,159,210,101,311,452,168,620,548,402,950,580,691,1271,214,533,747,2168,1987,4155
2020-09-03,3,6,9,0,1,1,12,14,26,46,15,61,104,58,162,211,101,312,458,169,627,555,408,963,589,696,1285,216,539,755,2194,2007,4201
2020-09-04,3,6,9,0,1,1,12,15,27,46,16,62,106,58,164,212,102,314,459,172,631,556,413,969,591,701,1292,217,541,758,2202,2025,4227
2020-09-05,3,6,9,0,1,1,12,15,27,46,16,62,106,59,165,213,103,316,464,175,639,564,416,980,596,710,1306,217,545,762,2221,2046,4267
2020-09-06,3,6,9,0,1,1,12,15,27,46,16,62,107,59,166,215,103,318,468,175,643,571,420,991,600,715,1315,220,549,769,2242,2059,4301
2020-09-07,3,6,9,0,1,1,12,15,27,46,16,62,108,60,168,217,103,320,473,181,654,580,426,1006,610,722,1332,221,554,775,2270,2084,4354
2020-09-08,3,6,9,0,1,1,12,15,27,46,16,62,108,60,168,218,104,322,478,183,661,591,433,1024,619,732,1351,223,559,782,2298,2109,4407
2020-09-09,3,6,9,0,1,1,13,15,28,46,16,62,109,61,170,223,105,328,484,186,670,599,437,1036,621,735,1356,226,567,793,2324,2129,4453
2020-09-10,3,6,9,0,1,1,13,15,28,46,17,63,109,61,170,224,105,329,486,188,674,609,439,1048,626,742,1368,227,574,801,2343,2148,4491
2020-09-11,3,6,9,0,1,1,13,15,28,47,17,64,110,62,172,225,105,330,490,190,680,614,444,1058,629,749,1378,227,576,803,2358,2165,4523
2020-09-12,3,6,9,0,1,1,13,15,28,47,17,64,110,62,172,226,107,333,492,192,684,618,448,1066,632,751,1383,227,584,811,2368,2183,4551
2020-09-13,3,6,9,0,1,1,13,15,28,47,17,64,111,62,173,226,107,333,496,194,690,622,450,1072,633,755,1388,227,585,812,2378,2192,4570
2020-09-14,3,6,9,0,1,1,14,15,29,48,17,65,112,62,174,228,107,335,497,195,692,629,456,1085,637,757,1394,229,589,818,2397,2205,4602
2020-09-15,3,6,9,0,1,1,14,15,29,48,17,65,112,62,174,230,109,339,500,197,697,633,460,1093,641,759,1400,231,592,823,2412,2218,4630
2020-09-16,3,6,9,1,1,2,14,15,29,49,17,66,112,62,174,230,110,340,504,198,702,637,465,1102,644,765,1409,232,596,828,2426,2235,4661
2020-09-17,3,6,9,1,1,2,14,15,29,49,17,66,112,62,174,230,110,340,506,199,705,643,467,1110,648,769,1417,234,600,834,2440,2246,4686
2020-09-18,3,6,9,1,1,2,15,16,31,50,17,67,112,63,175,230,111,341,510,200,710,644,470,1114,652,774,1426,235,603,838,2452,2261,4713
2020-09-19,3,6,9,1,1,2,15,16,31,50,17,67,112,63,175,231,111,342,512,202,714,648,473,1121,654,778,1432,235,607,842,2461,2274,4735
2020-09-20,3,6,9,1,1,2,15,16,31,50,17,67,115,63,178,232,111,343,515,203,718,649,475,1124,656,781,1437,235,609,844,2471,2282,4753
2020-09-21,3,6,9,1,1,2,15,16,31,50,17,67,116,63,179,232,111,343,517,203,720,653,479,1132,659,785,1444,235,611,846,2481,2292,4773
2020-09-22,3,6,9,1,1,2,15,16,31,50,17,67,116,63,179,233,112,345,520,206,726,656,480,1136,664,790,1454,236,614,850,2494,2305,4799
2020-09-23,3,6,9,1,1,2,15,16,31,50,17,67,116,64,180,237,112,349,521,209,730,662,484,1146,666,794,1460,237,616,853,2508,2319,4827
2020-09-24,3,6,9,1,1,2,15,16,31,50,17,67,116,64,180,240,113,353,523,209,732,665,485,1150,669,797,1466,240,618,858,2522,2326,4848
2020-09-25,3,6,9,1,1,2,15,16,31,50,18,68,116,65,181,242,113,355,526,209,735,672,492,1164,671,802,1473,242,624,866,2538,2346,4884
2020-09-26,3,6,9,1,1,2,15,16,31,50,18,68,116,65,181,242,113,355,527,210,737,678,494,1172,675,805,1480,243,625,868,2550,2353,4903
2020-09-27,3,6,9,1,1,2,15,16,31,50,18,68,116,65,181,242,113,355,529,211,740,682,498,1180,678,808,1486,244,628,872,2560,2364,4924
2020-09-28,3,6,9,1,1,2,15,16,31,50,18,68,116,67,183,244,113,357,534,213,747,686,499,1185,684,810,1494,247,628,875,2580,2371,4951
2020-09-29,3,6,9,1,1,2,15,16,31,51,18,69,116,67,183,245,113,358,538,214,752,689,502,1191,686,816,1502,249,630,879,2593,2383,4976
2020-09-30,3,6,9,1,1,2,16,16,32,51,18,69,116,68,184,245,113,358,542,217,759,695,502,1197,689,820,1509,252,633,885,2610,2394,5004
2020-10-01,4,6,10,1,1,2,16,16,32,51,18,69,117,68,185,246,113,359,548,220,768,697,506,1203,691,825,1516,253,635,888,2624,2408,5032
2020-10-02,4,6,10,1,1,2,16,16,32,51,18,69,117,69,186,247,113,360,551,222,773,699,512,1211,694,828,1522,255,637,892,2635,2422,5057
2020-10-03,4,6,10,1,1,2,17,16,33,51,18,69,117,69,186,247,113,360,552,222,774,702,512,1214,695,830,1525,256,637,893,2642,2424,5066
2020-10-04,4,6,10,1,1,2,17,16,33,51,18,69,118,69,187,249,113,362,553,222,775,703,514,1217,699,831,1530,256,638,894,2651,2428,5079
2020-10-05,4,6,10,1,1,2,17,16,33,51,18,69,119,69,188,251,113,364,556,224,780,705,516,1221,703,837,1540,256,640,896,2663,2440,5103
2020-10-06,4,6,10,1,1,2,17,16,33,51,18,69,119,70,189,251,113,364,557,225,782,707,517,1224,710,839,1549,257,640,897,2674,2445,5119
2020-10-07,4,6,10,1,1,2,17,16,33,51,18,69,119,70,189,251,113,364,558,225,783,708,521,1229,714,843,1557,257,642,899,2680,2455,5135
2020-10-08,4,6,10,1,1,2,17,16,33,51,18,69,119,70,189,251,113,364,560,225,785,712,526,1238,719,851,1570,258,644,902,2692,2470,5162
2020-10-09,4,6,10,1,1,2,17,16,33,51,18,69,119,70,189,255,114,369,563,226,789,716,526,1242,723,856,1579,259,645,904,2708,2478,5186
2020-10-10,4,6,10,1,1,2,17,16,33,51,18,69,120,70,190,256,114,370,564,226,790,719,528,1247,728,859,1587,259,645,904,2719,2483,5202
2020-10-11,4,6,10,1,1,2,17,16,33,52,18,70,121,71,192,256,114,370,565,227,792,721,530,1251,730,861,1591,260,645,905,2727,2489,5216
2020-10-12,4,6,10,1,1,2,17,16,33,52,18,70,122,71,193,257,114,371,567,228,795,724,531,1255,732,863,1595,261,645,906,2737,2493,5230
2020-10-13,4,6,10,1,1,2,17,16,33,52,18,70,122,71,193,260,114,374,571,230,801,725,531,1256,736,869,1605,262,646,908,2750,2502,5252
2020-10-14,4,6,10,1,1,2,18,16,34,52,18,70,123,71,194,262,114,376,572,231,803,728,533,1261,739,873,1612,263,649,912,2762,2512,5274
2020-10-15,4,6,10,1,1,2,18,16,34,52,18,70,125,71,196,262,116,378,573,231,804,731,535,1266,742,876,1618,263,650,913,2771,2520,5291
2020-10-16,4,6,10,1,1,2,18,16,34,52,18,70,126,71,197,262,116,378,576,232,808,734,537,1271,745,878,1623,265,657,922,2783,2532,5315
2020-10-17,4,6,10,1,1,2,18,17,35,52,18,70,126,73,199,262,117,379,578,233,811,738,538,1276,749,878,1627,267,659,926,2795,2540,5335
2020-10-18,4,6,10,1,1,2,19,17,36,53,18,71,126,73,199,263,117,380,578,233,811,740,540,1280,749,879,1628,267,660,927,2800,2544,5344
2020-10-19,4,7,11,1,1,2,19,17,36,53,18,71,126,73,199,263,117,380,578,234,812,743,543,1286,749,882,1631,267,660,927,2803,2552,5355
2020-10-20,4,7,11,1,1,2,19,17,36,54,18,72,126,74,200,264,117,381,578,235,813,746,544,1290,755,884,1639,268,660,928,2815,2557,5372
2020-10-21,4,7,11,1,1,2,19,17,36,54,18,72,126,74,200,265,118,383,580,237,817,749,544,1293,756,884,1640,268,660,928,2822,2560,5382
2020-10-22,4,7,11,1,1,2,19,17,36,54,18,72,126,74,200,266,118,384,580,238,818,751,546,1297,757,885,1642,268,660,928,2826,2564,5390
2020-10-23,4,7,11,1,1,2,19,17,36,54,18,72,126,74,200,266,118,384,584,240,824,752,549,1301,761,889,1650,269,661,930,2836,2574,5410
2020-10-24,4,7,11,1,1,2,19,17,36,54,18,72,126,74,200,268,118,386,586,240,826,753,552,1305,761,890,1651,269,663,932,2841,2580,5421
2020-10-25,4,7,11,1,1,2,19,17,36,55,18,73,126,74,200,268,118,386,587,240,827,754,553,1307,762,892,1654,269,664,933,2845,2584,5429
2020-10-26,4,7,11,1,1,2,19,17,36,55,18,73,126,74,200,269,118,387,590,240,830,757,555,1312,766,896,1662,271,665,936,2858,2591,5449
2020-10-27,4,7,11,1,1,2,19,17,36,55,18,73,126,75,201,272,119,391,591,240,831,759,557,1316,770,899,1669,272,665,937,2869,2598,5467
2020-10-28,4,7,11,1,1,2,20,17,37,55,18,73,126,75,201,273,119,392,592,240,832,761,557,1318,772,900,1672,274,666,940,2878,2600,5478
2020-10-29,4,7,11,1,1,2,20,17,37,55,18,73,127,75,202,273,120,393,593,240,833,763,557,1320,774,901,1675,274,666,940,2884,2602,5486
2020-10-30,4,7,11,1,1,2,20,17,37,55,18,73,127,75,202,273,121,394,594,241,835,764,557,1321,777,902,1679,275,667,942,2890,2606,5496
2020-10-31,4,7,11,1,1,2,20,17,37,55,18,73,127,75,202,273,121,394,595,241,836,765,558,1323,777,902,1679,275,667,942,2892,2607,5499
2020-11-01,4,7,11,1,1,2,20,17,37,55,18,73,127,75,202,273,121,394,595,241,836,765,559,1324,779,903,1682,275,667,942,2894,2609,5503
2020-11-02,4,7,11,1,1,2,20,17,37,55,18,73,127,75,202,274,121,395,595,241,836,765,559,1324,779,903,1682,275,668,943,2895,2610,5505
2020-11-03,4,7,11,1,1,2,20,17,37,55,18,73,127,75,202,274,121,395,595,242,837,766,562,1328,779,905,1684,275,669,944,2896,2617,5513
2020-11-04,4,7,11,1,1,2,20,17,37,55,18,73,127,75,202,274,122,396,596,242,838,767,563,1330,779,907,1686,276,670,946,2899,2622,5521
2020-11-05,4,7,11,1,1,2,20,17,37,55,18,73,127,75,202,274,122,396,599,242,841,769,565,1334,779,908,1687,277,670,947,2905,2625,5530
2020-11-06,4,7,11,1,1,2,20,17,37,55,18,73,127,76,203,274,122,396,602,242,844,771,566,1337,782,911,1693,278,671,949,2914,2631,5545
2020-11-07,4,7,11,1,1,2,20,17,37,55,18,73,127,76,203,274,122,396,602,244,846,771,568,1339,783,911,1694,278,671,949,2915,2635,5550
2020-11-08,4,7,11,1,1,2,20,17,37,55,18,73,127,76,203,274,122,396,603,244,847,772,568,1340,785,912,1697,279,671,950,2920,2636,5556
2020-11-09,4,7,11,1,1,2,20,18,38,55,18,73,127,76,203,274,122,396,604,245,849,778,569,1347,786,917,1703,279,673,952,2928,2646,5574
2020-11-10,4,7,11,1,1,2,20,18,38,55,18,73,127,76,203,275,122,397,607,245,852,778,574,1352,787,922,1709,279,673,952,2933,2656,5589
2020-11-11,4,7,11,1,1,2,20,18,38,55,18,73,127,76,203,277,123,400,607,245,852,779,576,1355,787,924,1711,280,674,954,2937,2662,5599
2020-11-12,4,7,11,1,1,2,20,18,38,55,18,73,127,76,203,277,123,400,608,245,853,780,576,1356,787,924,1711,280,676,956,2939,2664,5603
2020-11-13,4,7,11,1,1,2,20,18,38,55,18,73,127,76,203,278,123,401,609,245,854,783,576,1359,788,926,1714,281,678,959,2946,2668,5614
2020-11-14,4,7,11,1,1,2,20,18,38,55,18,73,127,76,203,279,123,402,610,245,855,786,576,1362,790,928,1718,281,678,959,2953,2670,5623
2020-11-15,4,7,11,1,1,2,20,18,38,55,18,73,127,76,203,279,123,402,612,245,857,787,576,1363,791,931,1722,282,678,960,2958,2673,5631
2020-11-16,4,7,11,1,1,2,20,18,38,55,18,73,127,76,203,279,123,402,614,245,859,787,576,1363,794,933,1727,284,680,964,2965,2677,5642
2020-11-17,4,7,11,1,1,2,20,18,38,55,18,73,127,76,203,280,123,403,618,245,863,788,576,1364,796,937,1733,284,681,965,2973,2682,5655
2020-11-18,4,7,11,1,1,2,20,18,38,55,18,73,128,76,204,280,123,403,618,245,863,792,576,1368,798,937,1735,284,682,966,2980,2683,5663
2020-11-19,4,7,11,1,1,2,20,18,38,55,18,73,128,77,205,280,123,403,618,245,863,794,576,1370,799,938,1737,284,683,967,2983,2686,5669
2020-11-20,4,7,11,1,1,2,20,18,38,55,18,73,128,77,205,280,123,403,619,245,864,795,577,1372,802,939,1741,285,683,968,2989,2688,5677
2020-11-21,4,7,11,1,1,2,20,18,38,55,18,73,128,77,205,280,123,403,619,245,864,796,577,1373,803,940,1743,285,683,968,2991,2689,5680
2020-11-22,4,7,11,1,1,2,20,18,38,55,18,73,128,77,205,281,123,404,621,245,866,797,579,1376,804,941,1745,285,684,969,2996,2693,5689
2020-11-23,4,7,11,1,1,2,20,18,38,55,18,73,128,77,205,281,123,404,621,245,866,799,581,1380,804,943,1747,285,685,970,2998,2698,5696
2020-11-24,4,7,11,1,1,2,20,18,38,55,18,73,128,77,205,281,123,404,623,245,868,800,581,1381,806,943,1749,285,686,971,3003,2699,5702
2020-11-25,4,7,11,1,1,2,20,18,38,55,18,73,130,77,207,281,123,404,624,246,870,801,582,1383,807,944,1751,286,687,973,3009,2703,5712
2020-11-26,4,7,11,1,1,2,20,18,38,57,18,75,130,77,207,281,123,404,625,246,871,801,582,1383,808,945,1753,287,688,975,3014,2705,5719
2020-11-27,4,7,11,1,1,2,20,18,38,57,18,75,130,77,207,282,123,405,626,246,872,802,584,1386,808,945,1753,288,690,978,3018,2709,5727
2020-11-28,4,7,11,1,1,2,20,18,38,57,18,75,131,77,208,282,123,405,627,246,873,802,585,1387,809,946,1755,288,690,978,3021,2711,5732
2020-11-29,4,7,11,1,1,2,20,18,38,57,18,75,131,77,208,282,123,405,628,246,874,803,585,1388,809,947,1756,289,690,979,3024,2712,5736
2020-11-30,4,7,11,1,1,2,20,18,38,57,18,75,131,77,208,282,123,405,628,246,874,804,586,1390,809,948,1757,289,691,980,3025,2715,5740
2020-12-01,4,7,11,1,1,2,20,18,38,57,18,75,131,77,208,283,123,406,628,246,874,804,588,1392,810,948,1758,289,691,980,3027,2717,5744
2020-12-02,4,7,11,1,1,2,20,18,38,57,18,75,131,77,208,283,123,406,630,248,878,804,590,1394,811,950,1761,289,696,985,3030,2728,5758
2020-12-03,4,7,11,1,1,2,20,18,38,57,18,75,131,77,208,284,123,407,631,248,879,805,592,1397,813,950,1763,289,696,985,3035,2730,5765
2020-12-04,4,7,11,1,1,2,20,18,38,57,18,75,131,77,208,284,123,407,633,248,881,806,593,1399,816,951,1767,290,696,986,3042,2732,5774
2020-12-05,4,7,11,1,1,2,20,18,38,57,18,75,131,77,208,284,123,407,633,248,881,806,594,1400,821,953,1774,290,696,986,3047,2735,5782
2020-12-06,4,7,11,1,1,2,20,18,38,57,18,75,131,77,208,284,123,407,634,248,882,807,595,1402,822,954,1776,290,696,986,3050,2737,5787
2020-12-07,4,7,11,1,1,2,20,18,38,57,18,75,131,77,208,285,123,408,634,249,883,810,596,1406,824,955,1779,290,696,986,3056,2740,5796
2020-12-08,4,7,11,1,1,2,20,18,38,57,18,75,131,77,208,285,123,408,637,250,887,811,599,1410,825,956,1781,291,697,988,3062,2746,5808
2020-12-09,4,7,11,1,1,2,20,18,38,57,19,76,131,77,208,285,123,408,639,250,889,811,600,1411,825,956,1781,291,697,988,3064,2748,5812
2020-12-10,4,7,11,1,1,2,20,18,38,57,20,77,131,77,208,287,123,410,640,250,890,814,603,1417,826,959,1785,291,698,989,3071,2756,5827
2020-12-11,4,7,11,1,1,2,20,18,38,57,20,77,131,77,208,287,124,411,641,250,891,814,604,1418,827,962,1789,291,699,990,3073,2762,5835
2020-12-12,4,7,11,1,1,2,20,18,38,57,20,77,131,77,208,287,125,412,641,250,891,816,604,1420,828,962,1790,291,699,990,3076,2763,5839
2020-12-13,4,7,11,1,1,2,20,18,38,57,20,77,132,77,209,287,125,412,642,250,892,818,605,1423,831,962,1793,292,699,991,3084,2764,5848
2020-12-14,4,7,11,1,1,2,20,18,38,57,20,77,132,77,209,287,125,412,644,250,894,822,607,1429,832,963,1795,292,699,991,3091,2767,5858
2020-12-15,4,7,11,1,1,2,20,18,38,57,20,77,132,77,209,287,125,412,646,250,896,824,609,1433,833,963,1796,292,700,992,3096,2770,5866
2020-12-16,4,7,11,1,1,2,20,18,38,57,20,77,132,77,209,287,125,412,647,251,898,827,611,1438,836,966,1802,293,701,994,3104,2777,5881
2020-12-17,4,7,11,1,1,2,20,18,38,57,20,77,132,77,209,288,125,413,647,251,898,830,615,1445,836,966,1802,293,702,995,3108,2782,5890
2020-12-18,4,7,11,1,1,2,20,18,38,58,20,78,132,77,209,290,125,415,647,252,899,834,615,1449,836,970,1806,293,705,998,3115,2790,5905
2020-12-19,4,7,11,1,1,2,20,18,38,58,20,78,132,77,209,291,125,416,649,253,902,836,615,1451,836,972,1808,293,706,999,3120,2794,5914
2020-12-20,4,7,11,1,1,2,20,18,38,58,20,78,132,77,209,291,125,416,651,255,906,837,615,1452,837,972,1809,295,707,1002,3126,2797,5923
2020-12-21,4,7,11,1,1,2,20,18,38,58,20,78,133,77,210,293,125,418,654,256,910,840,616,1456,839,975,1814,296,709,1005,3138,2804,5942
2020-12-22,4,7,11,1,1,2,20,18,38,58,20,78,133,77,210,293,125,418,657,256,913,841,617,1458,839,976,1815,296,710,1006,3142,2807,5949
2020-12-23,4,7,11,1,1,2,20,18,38,58,20,78,133,78,211,295,125,420,660,256,916,845,620,1465,842,979,1821,296,710,1006,3154,2814,5968
2020-12-24,4,7,11,1,1,2,20,18,38,58,20,78,133,78,211,295,125,420,661,256,917,845,620,1465,843,980,1823,296,711,1007,3156,2816,5972
2020-12-25,4,7,11,1,1,2,20,18,38,58,20,78,134,79,213,296,125,421,662,257,919,847,620,1467,843,980,1823,296,712,1008,3161,2819,5980
2020-12-26,4,7,11,1,1,2,20,18,38,58,21,79,134,79,213,298,125,423,662,257,919,850,624,1474,845,982,1827,296,713,1009,3168,2827,5995
2020-12-27,4,7,11,1,1,2,20,18,38,58,21,79,135,79,214,299,125,424,665,257,922,854,625,1479,847,983,1830,296,713,1009,3179,2829,6008
2020-12-28,4,7,11,1,1,2,20,18,38,58,21,79,136,79,215,300,125,425,667,258,925,861,626,1487,853,988,1841,297,714,1011,3197,2837,6034
2020-12-29,4,7,11,1,1,2,20,18,38,58,21,79,136,79,215,300,126,426,672,259,931,864,627,1491,857,989,1846,299,715,1014,3211,2842,6053
2020-12-30,4,7,11,1,1,2,20,18,38,58,21,79,136,79,215,302,126,428,672,260,932,868,628,1496,858,992,1850,299,715,1014,3218,2847,6065
2020-12-31,4,7,11,1,1,2,20,18,38,58,21,79,136,79,215,303,126,429,673,261,934,870,630,1500,860,994,1854,299,715,1014,3224,2852,6076
2021-01-01,4,7,11,1,1,2,20,18,38,58,21,79,136,79,215,303,126,429,675,262,937,873,632,1505,860,994,1854,299,715,1014,3229,2855,6084
2021-01-02,4,7,11,1,1,2,20,18,38,58,21,79,137,79,216,304,128,432,675,265,940,873,632,1505,862,995,1857,302,715,1017,3236,2861,6097
2021-01-03,4,7,11,1,1,2,20,18,38,58,21,79,137,79,216,307,130,437,675,265,940,875,633,1508,863,997,1860,302,715,1017,3242,2866,6108
2021-01-04,4,7,11,1,1,2,20,18,38,58,21,79,137,79,216,308,130,438,676,266,942,880,633,1513,870,1004,1874,304,717,1021,3258,2876,6134
2021-01-05,4,7,11,1,1,2,20,18,38,58,22,80,138,79,217,308,130,438,679,267,946,881,633,1514,871,1006,1877,304,721,1025,3264,2884,6148
2021-01-06,4,7,11,1,1,2,20,18,38,58,22,80,140,79,219,310,131,441,683,267,950,887,635,1522,871,1009,1880,304,721,1025,3278,2890,6168
2021-01-07,4,7,11,1,1,2,21,18,39,58,22,80,140,80,220,310,132,442,685,268,953,890,639,1529,876,1011,1887,309,722,1031,3294,2900,6194
2021-01-08,4,7,11,1,1,2,21,18,39,58,22,80,140,80,220,313,133,446,691,269,960,893,641,1534,878,1016,1894,309,723,1032,3308,2910,6218
2021-01-09,4,7,11,1,1,2,21,18,39,58,22,80,141,80,221,314,134,448,691,269,960,896,644,1540,878,1018,1896,309,725,1034,3313,2918,6231
2021-01-10,4,7,11,1,1,2,21,18,39,58,22,80,141,80,221,316,134,450,693,270,963,900,645,1545,880,1019,1899,309,725,1034,3323,2921,6244
2021-01-11,4,7,11,1,1,2,21,18,39,58,23,81,142,80,222,317,134,451,700,270,970,905,646,1551,881,1022,1903,309,728,1037,3338,2929,6267
2021-01-12,4,7,11,1,1,2,21,18,39,58,23,81,142,80,222,318,134,452,704,272,976,910,647,1557,884,1025,1909,309,731,1040,3351,2938,6289
2021-01-13,4,7,11,1,1,2,21,18,39,58,23,81,142,80,222,322,137,459,707,273,980,914,647,1561,887,1027,1914,310,733,1043,3366,2946,6312
2021-01-14,4,7,11,1,1,2,21,18,39,58,23,81,142,80,222,324,137,461,710,275,985,920,650,1570,892,1027,1919,312,733,1045,3384,2951,6335
2021-01-15,4,7,11,1,1,2,21,18,39,59,23,82,142,81,223,325,137,462,712,275,987,921,654,1575,897,1030,1927,312,733,1045,3394,2959,6353
2021-01-16,4,7,11,1,1,2,21,18,39,59,23,82,142,81,223,325,137,462,712,276,988,923,656,1579,898,1033,1931,312,733,1045,3397,2965,6362
2021-01-17,4,7,11,1,1,2,21,18,39,59,24,83,142,81,223,325,137,462,714,276,990,928,656,1584,900,1034,1934,314,733,1047,3408,2967,6375
2021-01-18,4,7,11,1,1,2,21,18,39,59,24,83,142,81,223,325,137,462,717,279,996,931,658,1589,902,1037,1939,315,736,1051,3417,2978,6395
2021-01-19,4,7,11,1,1,2,21,18,39,59,24,83,142,81,223,326,137,463,720,279,999,933,659,1592,908,1042,1950,315,738,1053,3429,2986,6415
2021-01-20,4,7,11,1,1,2,21,18,39,59,25,84,142,81,223,328,137,465,724,279,1003,937,660,1597,912,1046,1958,315,742,1057,3443,2996,6439
2021-01-21,4,7,11,1,1,2,21,18,39,59,25,84,143,81,224,331,138,469,727,281,1008,942,662,1604,916,1051,1967,317,743,1060,3461,3007,6468
2021-01-22,4,7,11,1,1,2,21,18,39,59,25,84,143,81,224,331,138,469,731,283,1014,943,662,1605,918,1054,1972,318,744,1062,3469,3013,6482
2021-01-23,4,7,11,1,1,2,21,18,39,60,25,85,143,81,224,331,138,469,731,283,1014,949,666,1615,919,1058,1977,318,744,1062,3477,3021,6498
2021-01-24,4,7,11,1,1,2,21,18,39,60,25,85,143,81,224,331,138,469,732,283,1015,951,668,1619,920,1058,1978,318,744,1062,3481,3023,6504
2021-01-25,4,7,11,1,1,2,21,18,39,60,26,86,143,81,224,332,138,470,733,284,1017,955,671,1626,922,1061,1983,319,745,1064,3490,3032,6522
2021-01-26,4,7,11,1,1,2,21,18,39,60,26,86,144,81,225,333,139,472,736,285,1021,957,673,1630,926,1065,1991,319,747,1066,3501,3042,6543
2021-01-27,4,7,11,1,1,2,21,18,39,60,26,86,145,81,226,333,139,472,737,286,1023,960,674,1634,929,1069,1998,320,748,1068,3510,3049,6559
2021-01-28,4,7,11,1,1,2,21,18,39,60,26,86,145,81,226,333,139,472,738,287,1025,962,677,1639,931,1070,2001,320,749,1069,3515,3055,6570
2021-01-29,4,7,11,1,1,2,21,18,39,60,26,86,145,82,227,334,139,473,740,287,1027,966,677,1643,933,1073,2006,322,751,1073,3526,3061,6587
2021-01-30,4,7,11,1,1,2,21,18,39,60,26,86,145,82,227,336,139,475,742,288,1030,966,679,1645,933,1075,2008,323,751,1074,3531,3066,6597
2021-01-31,4,7,11,1,1,2,21,18,39,60,26,86,145,82,227,337,139,476,742,288,1030,972,681,1653,933,1076,2009,323,752,1075,3538,3070,6608
2021-02-01,4,7,11,1,1,2,21,18,39,60,26,86,145,82,227,338,140,478,745,289,1034,976,684,1660,936,1080,2016,323,753,1076,3549,3080,6629
2021-02-02,4,7,11,1,1,2,21,18,39,60,26,86,145,82,227,339,142,481,746,289,1035,979,688,1667,938,1085,2023,323,755,1078,3556,3093,6649
2021-02-03,4,7,11,1,1,2,21,18,39,60,26,86,147,82,229,339,142,481,748,292,1040,981,689,1670,943,1086,2029,324,755,1079,3568,3098,6666
2021-02-04,4,7,11,1,1,2,21,18,39,60,26,86,148,83,231,340,142,482,754,294,1048,987,693,1680,947,1089,2036,324,757,1081,3586,3110,6696
2021-02-05,4,7,11,1,1,2,21,18,39,60,26,86,148,83,231,340,142,482,757,295,1052,990,694,1684,950,1090,2040,324,759,1083,3595,3115,6710
2021-02-06,4,7,11,1,1,2,21,18,39,60,26,86,148,84,232,340,143,483,759,297,1056,994,696,1690,951,1090,2041,324,760,1084,3602,3122,6724
2021-02-07,4,7,11,1,1,2,21,18,39,60,26,86,148,84,232,340,144,484,760,299,1059,999,697,1696,955,1092,2047,324,761,1085,3612,3129,6741
2021-02-08,4,7,11,1,1,2,21,18,39,60,26,86,148,84,232,343,144,487,764,299,1063,1005,704,1709,958,1096,2054,324,763,1087,3628,3142,6770
2021-02-09,4,7,11,1,1,2,21,18,39,60,26,86,149,84,233,343,144,487,765,301,1066,1006,706,1712,961,1098,2059,324,763,1087,3634,3148,6782
2021-02-10,4,7,11,1,1,2,21,18,39,61,26,87,149,84,233,344,144,488,766,302,1068,1008,709,1717,961,1101,2062,325,764,1089,3640,3156,6796
2021-02-11,4,7,11,1,1,2,21,18,39,61,26,87,149,84,233,344,144,488,768,303,1071,1011,710,1721,963,1101,2064,326,765,1091,3648,3159,6807
2021-02-12,4,7,11,1,1,2,21,18,39,61,26,87,149,84,233,345,145,490,770,305,1075,1014,715,1729,966,1104,2070,328,766,1094,3659,3171,6830
2021-02-13,4,7,11,1,1,2,21,18,39,61,26,87,149,85,234,345,145,490,771,305,1076,1019,718,1737,966,1107,2073,329,767,1096,3666,3179,6845
2021-02-14,4,7,11,1,1,2,21,18,39,61,26,87,149,85,234,345,145,490,771,305,1076,1023,722,1745,966,1108,2074,329,767,1096,3670,3184,6854
2021-02-15,4,7,11,1,1,2,21,18,39,62,26,88,150,85,235,345,145,490,773,305,1078,1024,723,1747,967,1109,2076,330,768,1098,3677,3187,6864
2021-02-16,4,7,11,1,1,2,21,18,39,62,26,88,150,85,235,345,145,490,773,305,1078,1027,724,1751,969,1111,2080,330,773,1103,3682,3195,6877
2021-02-17,4,7,11,1,1,2,21,18,39,62,26,88,150,85,235,345,145,490,774,305,1079,1029,724,1753,972,1113,2085,330,773,1103,3688,3197,6885
2021-02-18,4,7,11,1,1,2,21,18,39,63,26,89,150,85,235,346,146,492,777,306,1083,1033,725,1758,972,1115,2087,330,773,1103,3697,3202,6899
2021-02-19,4,7,11,1,1,2,21,18,39,63,26,89,150,85,235,349,148,497,778,308,1086,1033,725,1758,974,1115,2089,330,773,1103,3703,3206,6909
2021-02-20,4,7,11,1,1,2,21,18,39,63,26,89,151,85,236,349,148,497,779,308,1087,1034,726,1760,975,1117,2092,331,774,1105,3708,3210,6918
2021-02-21,4,7,11,1,1,2,21,18,39,63,27,90,151,85,236,349,148,497,781,308,1089,1036,728,1764,976,1118,2094,331,775,1106,3713,3215,6928
2021-02-22,4,7,11,1,1,2,21,18,39,63,27,90,151,85,236,350,148,498,783,309,1092,1038,730,1768,978,1120,2098,333,775,1108,3722,3220,6942
2021-02-23,4,7,11,1,1,2,21,18,39,63,27,90,151,85,236,351,149,500,783,309,1092,1040,732,1772,981,1122,2103,334,775,1109,3729,3225,6954
2021-02-24,4,7,11,1,1,2,21,18,39,63,28,91,151,85,236,352,149,501,784,310,1094,1042,733,1775,981,1122,2103,336,778,1114,3735,3231,6966
2021-02-25,4,7,11,1,1,2,21,18,39,63,28,91,151,85,236,353,149,502,786,310,1096,1045,734,1779,982,1122,2104,337,779,1116,3743,3233,6976
2021-02-26,4,7,11,1,1,2,21,18,39,63,28,91,151,85,236,354,149,503,786,311,1097,1049,735,1784,983,1124,2107,339,783,1122,3751,3241,6992
2021-02-27,4,7,11,1,1,2,21,18,39,63,28,91,151,85,236,356,149,505,786,311,1097,1050,738,1788,988,1127,2115,339,784,1123,3759,3248,7007
2021-02-28,4,7,11,1,1,2,21,18,39,63,28,91,151,85,236,357,149,506,786,311,1097,1051,738,1789,988,1128,2116,339,784,1123,3761,3249,7010
2021-03-01,4,7,11,1,1,2,21,18,39,63,28,91,151,85,236,358,149,507,787,311,1098,1053,742,1795,989,1132,2121,339,784,1123,3766,3257,7023
2021-03-02,4,7,11,1,1,2,21,18,39,63,28,91,152,85,237,358,149,507,789,312,1101,1056,743,1799,991,1133,2124,339,785,1124,3774,3261,7035
2021-03-03,4,7,11,1,1,2,21,18,39,63,28,91,153,85,238,359,149,508,790,313,1103,1057,744,1801,994,1133,2127,339,785,1124,3781,3263,7044
2021-03-04,4,7,11,2,1,3,21,18,39,63,28,91,153,85,238,360,149,509,791,315,1106,1058,746,1804,996,1133,2129,340,785,1125,3788,3267,7055
2021-03-05,4,7,11,2,1,3,21,18,39,63,28,91,153,85,238,362,150,512,793,315,1108,1061,747,1808,997,1135,2132,340,785,1125,3796,3271,7067
2021-03-06,4,7,11,2,1,3,21,19,40,63,28,91,153,85,238,362,150,512,794,315,1109,1062,747,1809,998,1135,2133,340,786,1126,3799,3273,7072
2021-03-07,4,7,11,2,1,3,21,19,40,63,28,91,153,85,238,362,150,512,795,317,1112,1064,747,1811,999,1135,2134,340,787,1127,3803,3276,7079
2021-03-08,4,7,11,2,1,3,21,19,40,63,28,91,153,85,238,362,152,514,797,317,1114,1066,747,1813,1002,1136,2138,341,787,1128,3811,3279,7090
2021-03-09,4,7,11,2,1,3,21,19,40,63,28,91,153,85,238,365,152,517,799,318,1117,1070,747,1817,1006,1138,2144,341,788,1129,3824,3283,7107
2021-03-10,4,7,11,2,1,3,21,19,40,63,28,91,154,85,239,365,152,517,800,321,1121,1075,753,1828,1006,1139,2145,341,790,1131,3831,3295,7126
2021-03-11,4,7,11,2,1,3,21,19,40,63,28,91,154,85,239,367,152,519,804,321,1125,1077,754,1831,1010,1141,2151,342,791,1133,3844,3299,7143
2021-03-12,4,7,11,2,1,3,21,19,40,63,28,91,154,86,240,368,153,521,804,321,1125,1085,757,1842,1011,1145,2156,342,796,1138,3854,3313,7167
2021-03-13,4,7,11,2,1,3,21,19,40,63,28,91,154,86,240,368,153,521,805,321,1126,1087,760,1847,1013,1145,2158,343,796,1139,3860,3316,7176
2021-03-14,4,7,11,2,1,3,21,19,40,63,28,91,155,86,241,368,153,521,806,321,1127,1090,761,1851,1016,1146,2162,343,796,1139,3868,3318,7186
2021-03-15,4,7,11,2,1,3,21,19,40,63,28,91,155,86,241,369,153,522,807,323,1130,1092,763,1855,1016,1149,2165,343,798,1141,3872,3327,7199
2021-03-16,4,7,11,2,1,3,21,19,40,63,28,91,155,86,241,371,153,524,808,323,1131,1093,764,1857,1018,1153,2171,344,799,1143,3879,3333,7212
2021-03-17,4,7,11,2,1,3,21,19,40,63,28,91,155,86,241,371,153,524,811,323,1134,1097,767,1864,1019,1153,2172,344,801,1145,3887,3338,7225
2021-03-18,4,7,11,2,1,3,21,19,40,63,28,91,156,86,242,372,153,525,811,324,1135,1100,772,1872,1020,1156,2176,344,803,1147,3893,3349,7242
2021-03-19,4,7,11,2,1,3,21,19,40,63,28,91,156,86,242,374,154,528,815,326,1141,1101,777,1878,1021,1159,2180,344,803,1147,3901,3360,7261
2021-03-20,4,7,11,2,1,3,22,19,41,63,28,91,156,86,242,375,155,530,818,328,1146,1103,777,1880,1022,1160,2182,344,803,1147,3909,3364,7273
2021-03-21,4,7,11,2,1,3,22,19,41,63,28,91,156,86,242,377,155,532,819,328,1147,1107,779,1886,1024,1163,2187,344,803,1147,3918,3369,7287
2021-03-22,4,7,11,2,1,3,22,19,41,63,28,91,156,86,242,377,155,532,822,330,1152,1108,779,1887,1028,1164,2192,345,805,1150,3927,3374,7301
2021-03-23,4,7,11,2,1,3,22,19,41,63,28,91,157,86,243,378,156,534,825,331,1156,1115,783,1898,1030,1165,2195,345,806,1151,3941,3382,7323
2021-03-24,4,7,11,2,1,3,22,19,41,63,28,91,158,87,245,378,156,534,828,332,1160,1121,783,1904,1031,1165,2196,347,807,1154,3954,3385,7339
2021-03-25,4,7,11,2,1,3,22,19,41,64,28,92,158,88,246,378,158,536,830,334,1164,1125,787,1912,1035,1170,2205,347,807,1154,3965,3399,7364
2021-03-26,4,7,11,2,1,3,22,19,41,64,28,92,159,88,247,379,158,537,833,336,1169,1133,792,1925,1040,1171,2211,348,808,1156,3984,3408,7392
2021-03-27,4,7,11,2,1,3,22,19,41,65,28,93,159,89,248,381,158,539,837,337,1174,1140,795,1935,1047,1176,2223,349,810,1159,4006,3420,7426
2021-03-28,4,7,11,2,1,3,22,19,41,65,29,94,161,89,250,383,159,542,837,340,1177,1148,798,1946,1049,1176,2225,349,810,1159,4020,3428,7448
2021-03-29,4,7,11,2,1,3,22,19,41,65,29,94,161,89,250,388,159,547,844,343,1187,1160,802,1962,1055,1179,2234,351,813,1164,4052,3441,7493
2021-03-30,4,7,11,2,1,3,22,19,41,66,30,96,163,89,252,389,161,550,850,343,1193,1168,804,1972,1056,1184,2240,353,814,1167,4073,3452,7525
2021-03-31,4,7,11,2,1,3,22,19,41,66,30,96,163,90,253,393,161,554,856,345,1201,1175,811,1986,1058,1186,2244,353,815,1168,4092,3465,7557
2021-04-01,4,7,11,2,1,3,22,19,41,66,31,97,164,90,254,398,161,559,862,348,1210,1182,812,1994,1059,1188,2247,355,815,1170,4114,3472,7586
2021-04-02,4,7,11,2,1,3,22,19,41,67,31,98,166,90,256,400,161,561,869,352,1221,1186,815,2001,1060,1190,2250,356,815,1171,4132,3481,7613
2021-04-03,4,7,11,2,1,3,22,19,41,67,31,98,168,90,258,404,161,565,872,355,1227,1196,820,2016,1062,1190,2252,358,816,1174,4155,3490,7645
2021-04-04,5,7,12,2,1,3,23,19,42,67,32,99,168,90,258,406,162,568,880,357,1237,1203,822,2025,1066,1191,2257,359,817,1176,4179,3498,7677
2021-04-05,5,7,12,2,1,3,23,19,42,67,32,99,169,91,260,406,162,568,889,365,1254,1210,825,2035,1072,1197,2269,359,818,1177,4202,3517,7719
2021-04-06,5,7,12,2,1,3,23,19,42,67,32,99,170,91,261,411,165,576,896,369,1265,1221,831,2052,1079,1199,2278,361,821,1182,4235,3535,7770
2021-04-07,5,7,12,2,1,3,24,19,43,69,32,101,172,92,264,414,169,583,900,372,1272,1230,837,2067,1082,1200,2282,363,825,1188,4261,3554,7815
2021-04-08,5,7,12,2,1,3,24,19,43,69,32,101,173,92,265,420,170,590,906,375,1281,1241,841,2082,1086,1201,2287,364,827,1191,4290,3565,7855
2021-04-09,5,7,12,2,1,3,24,19,43,69,32,101,175,92,267,425,170,595,918,381,1299,1249,845,2094,1090,1203,2293,366,830,1196,4323,3580,7903
2021-04-10,5,7,12,2,1,3,24,19,43,69,33,102,175,92,267,432,170,602,925,385,1310,1255,850,2105,1091,1205,2296,367,833,1200,4345,3595,7940
2021-04-11,5,7,12,2,1,3,24,20,44,70,33,103,175,92,267,438,172,610,936,388,1324,1265,862,2127,1095,1210,2305,369,837,1206,4379,3622,8001
2021-04-12,5,7,12,2,1,3,24,21,45,70,33,103,176,93,269,442,174,616,941,394,1335,1275,872,2147,1096,1214,2310,369,838,1207,4400,3647,8047
2021-04-13,5,7,12,2,1,3,24,21,45,70,33,103,177,96,273,452,175,627,950,397,1347,1289,879,2168,1101,1220,2321,369,841,1210,4439,3670,8109
2021-04-14,6,7,13,2,1,3,24,21,45,71,34,105,180,96,276,461,177,638,964,404,1368,1307,885,2192,1103,1221,2324,371,844,1215,4489,3690,8179
2021-04-15,6,7,13,2,1,3,24,21,45,72,34,106,180,96,276,463,181,644,973,408,1381,1312,892,2204,1106,1227,2333,371,846,1217,4509,3713,8222
2021-04-16,6,7,13,2,1,3,24,21,45,72,34,106,181,97,278,465,182,647,981,413,1394,1325,895,2220,1112,1231,2343,373,848,1221,4541,3729,8270
2021-04-17,6,7,13,2,1,3,24,21,45,73,34,107,183,98,281,471,184,655,992,418,1410,1338,909,2247,1114,1234,2348,374,850,1224,4577,3756,8333
2021-04-18,6,7,13,2,1,3,24,21,45,73,34,107,184,99,283,475,185,660,1000,422,1422,1345,916,2261,1120,1239,2359,375,854,1229,4604,3778,8382
2021-04-19,6,7,13,2,1,3,24,21,45,73,35,108,185,99,284,478,187,665,1007,430,1437,1357,919,2276,1124,1247,2371,375,857,1232,4631,3803,8434
2021-04-20,6,7,13,2,1,3,24,21,45,73,35,108,187,103,290,483,187,670,1015,435,1450,1366,922,2288,1132,1255,2387,377,859,1236,4665,3825,8490
2021-04-21,6,7,13,2,1,3,24,21,45,73,35,108,187,103,290,494,195,689,1024,443,1467,1382,928,2310,1140,1261,2401,378,863,1241,4710,3857,8567
2021-04-22,6,7,13,2,1,3,25,21,46,73,35,108,189,104,293,496,195,691,1032,448,1480,1391,938,2329,1149,1265,2414,380,866,1246,4743,3880,8623
2021-04-23,6,7,13,2,1,3,25,21,46,74,35,109,191,104,295,500,197,697,1041,455,1496,1394,941,2335,1154,1266,2420,381,872,1253,4768,3899,8667
2021-04-24,6,7,13,2,1,3,25,21,46,76,36,112,192,104,296,507,197,704,1051,459,1510,1401,943,2344,1156,1272,2428,381,872,1253,4797,3912,8709
2021-04-25,6,7,13,2,1,3,25,21,46,77,36,113,192,106,298,511,197,708,1058,464,1522,1408,950,2358,1160,1276,2436,382,873,1255,4821,3931,8752
2021-04-26,6,7,13,2,1,3,27,21,48,78,36,114,192,106,298,517,198,715,1065,471,1536,1415,961,2376,1162,1281,2443,384,876,1260,4848,3958,8806
2021-04-27,6,7,13,2,1,3,27,21,48,79,37,116,194,107,301,522,202,724,1077,474,1551,1425,968,2393,1170,1285,2455,386,878,1264,4888,3980,8868
2021-04-28,6,7,13,2,1,3,28,21,49,80,39,119,196,109,305,527,205,732,1091,481,1572,1431,973,2404,1170,1288,2458,387,879,1266,4918,4003,8921
2021-04-29,7,7,14,2,1,3,28,21,49,80,39,119,199,110,309,534,209,743,1101,491,1592,1433,983,2416,1174,1292,2466,387,879,1266,4945,4032,8977
2021-04-30,7,7,14,2,1,3,28,21,49,80,39,119,201,112,313,535,210,745,1107,499,1606,1442,991,2433,1178,1293,2471,389,881,1270,4969,4054,9023
2021-05-01,7,7,14,2,1,3,28,22,50,83,39,122,201,112,313,536,212,748,1115,505,1620,1449,995,2444,1179,1295,2474,389,883,1272,4989,4071,9060
2021-05-02,7,7,14,2,1,3,28,22,50,83,39,122,203,112,315,539,214,753,1121,506,1627,1453,998,2451,1183,1298,2481,390,885,1275,5009,4082,9091
2021-05-03,7,7,14,2,1,3,28,22,50,84,41,125,204,112,316,545,215,760,1128,509,1637,1459,1004,2463,1187,1308,2495,394,886,1280,5038,4105,9143
2021-05-04,8,7,15,2,1,3,29,22,51,84,41,125,204,114,318,549,217,766,1141,515,1656,1467,1010,2477,1190,1314,2504,395,888,1283,5069,4129,9198
2021-05-05,8,7,15,2,1,3,29,22,51,84,42,126,207,115,322,555,222,777,1154,520,1674,1469,1014,2483,1195,1319,2514,398,890,1288,5101,4152,9253
2021-05-06,8,7,15,2,1,3,29,22,51,85,42,127,213,116,329,563,223,786,1163,524,1687,1473,1016,2489,1199,1322,2521,398,892,1290,5133,4165,9298
2021-05-07,8,7,15,2,1,3,29,22,51,85,42,127,214,117,331,566,224,790,1169,528,1697,1476,1020,2496,1205,1326,2531,399,894,1293,5153,4181,9334
2021-05-08,8,7,15,3,1,4,29,22,51,86,42,128,215,117,332,573,224,797,1175,532,1707,1480,1022,2502,1206,1330,2536,402,898,1300,5177,4195,9372
2021-05-09,8,7,15,3,1,4,29,22,51,86,42,128,216,118,334,573,224,797,1183,538,1721,1485,1024,2509,1208,1333,2541,402,901,1303,5193,4210,9403
2021-05-10,8,7,15,3,1,4,29,22,51,86,42,128,218,118,336,576,226,802,1195,543,1738,1495,1028,2523,1213,1344,2557,404,904,1308,5227,4235,9462
2021-05-11,8,7,15,3,1,4,29,22,51,88,42,130,221,118,339,578,229,807,1201,546,1747,1501,1036,2537,1218,1348,2566,406,906,1312,5253,4255,9508
2021-05-12,8,7,15,3,1,4,29,22,51,89,42,131,222,119,341,586,230,816,1211,549,1760,1504,1039,2543,1221,1349,2570,409,907,1316,5282,4265,9547
2021-05-13,8,7,15,3,1,4,30,24,54,90,42,132,224,119,343,593,233,826,1216,552,1768,1509,1042,2551,1223,1351,2574,410,908,1318,5306,4279,9585
2021-05-14,8,7,15,3,1,4,30,24,54,91,43,134,227,120,347,596,237,833,1218,557,1775,1516,1048,2564,1225,1356,2581,410,911,1321,5324,4304,9628
2021-05-15,8,7,15,3,1,4,30,24,54,91,43,134,229,121,350,599,239,838,1223,560,1783,1523,1055,2578,1229,1356,2585,410,912,1322,5345,4318,9663
2021-05-16,8,7,15,3,1,4,30,24,54,94,45,139,231,121,352,605,240,845,1229,564,1793,1531,1058,2589,1230,1359,2589,411,917,1328,5372,4336,9708
2021-05-17,8,7,15,3,1,4,31,24,55,94,46,140,234,123,357,608,247,855,1241,569,1810,1541,1065,2606,1237,1364,2601,415,919,1334,5412,4365,9777
2021-05-18,8,7,15,3,1,4,31,24,55,94,46,140,237,124,361,613,248,861,1248,572,1820,1548,1070,2618,1238,1369,2607,417,921,1338,5437,4382,9819
2021-05-19,8,7,15,4,1,5,31,24,55,94,46,140,240,125,365,619,249,868,1261,576,1837,1554,1075,2629,1243,1372,2615,419,923,1342,5473,4398,9871
2021-05-20,8,7,15,4,1,5,31,24,55,95,46,141,244,129,373,627,250,877,1270,580,1850,1565,1084,2649,1247,1376,2623,419,925,1344,5510,4422,9932
2021-05-21,9,7,16,4,1,5,31,24,55,96,46,142,246,129,375,634,251,885,1278,584,1862,1570,1090,2660,1249,1379,2628,421,926,1347,5538,4437,9975
2021-05-22,9,7,16,4,1,5,31,24,55,97,46,143,248,130,378,637,255,892,1286,589,1875,1578,1093,2671,1251,1385,2636,424,932,1356,5565,4462,10027
2021-05-23,9,7,16,4,2,6,31,24,55,98,46,144,248,130,378,644,257,901,1290,590,1880,1585,1098,2683,1258,1388,2646,426,934,1360,5593,4476,10069
2021-05-24,9,7,16,4,2,6,32,25,57,99,46,145,254,132,386,648,258,906,1298,592,1890,1594,1102,2696,1265,1391,2656,427,936,1363,5630,4491,10121
2021-05-25,9,7,16,4,2,6,32,25,57,101,46,147,260,133,393,650,259,909,1302,595,1897,1597,1103,2700,1271,1393,2664,427,937,1364,5653,4500,10153
2021-05-26,9,7,16,4,2,6,32,26,58,101,46,147,260,133,393,660,260,920,1312,600,1912,1605,1111,2716,1279,1403,2682,427,939,1366,5689,4527,10216
2021-05-27,9,7,16,4,2,6,32,26,58,101,46,147,263,134,397,666,262,928,1321,600,1921,1614,1115,2729,1283,1409,2692,428,943,1371,5721,4544,10265
2021-05-28,9,7,16,4,2,6,32,26,58,102,46,148,264,135,399,670,265,935,1327,602,1929,1617,1117,2734,1283,1416,2699,430,943,1373,5738,4559,10297
2021-05-29,9,7,16,4,2,6,32,26,58,102,46,148,265,135,400,677,265,942,1329,609,1938,1619,1119,2738,1286,1419,2705,430,943,1373,5753,4571,10324
2021-05-30,9,7,16,4,2,6,32,27,59,102,46,148,268,136,404,680,265,945,1332,612,1944,1623,1125,2748,1288,1422,2710,430,945,1375,5768,4587,10355
2021-05-31,9,7,16,4,2,6,32,27,59,103,46,149,269,138,407,688,269,957,1337,615,1952,1625,1127,2752,1295,1424,2719,431,947,1378,5793,4602,10395
2021-06-01,9,7,16,4,2,6,32,27,59,103,46,149,271,139,410,693,271,964,1343,616,1959,1629,1130,2759,1298,1428,2726,434,950,1384,5816,4616,10432
2021-06-02,9,7,16,4,2,6,32,27,59,103,46,149,271,139,410,696,276,972,1347,618,1965,1635,1136,2771,1302,1433,2735,437,953,1390,5836,4637,10473
2021-06-03,9,7,16,4,2,6,32,27,59,103,46,149,273,140,413,701,279,980,1349,621,1970,1642,1141,2783,1307,1438,2745,440,953,1393,5860,4654,10514
2021-06-04,9,7,16,4,2,6,32,27,59,104,46,150,275,140,415,709,280,989,1351,623,1974,1644,1142,2786,1312,1445,2757,440,955,1395,5880,4667,10547
2021-06-05,9,7,16,4,2,6,32,27,59,104,46,150,276,140,416,712,281,993,1356,626,1982,1648,1145,2793,1317,1450,2767,442,957,1399,5900,4681,10581
2021-06-06,9,8,17,4,2,6,32,27,59,104,47,151,276,140,416,717,282,999,1358,626,1984,1650,1146,2796,1318,1452,2770,444,959,1403,5912,4689,10601
2021-06-07,9,8,17,4,2,6,32,27,59,105,47,152,278,140,418,724,284,1008,1364,627,1991,1652,1149,2801,1326,1456,2782,446,962,1408,5940,4702,10642
2021-06-08,9,9,18,4,2,6,32,27,59,105,47,152,280,140,420,727,287,1014,1368,629,1997,1659,1151,2810,1333,1460,2793,448,962,1410,5965,4714,10679
2021-06-09,9,9,18,4,2,6,32,27,59,106,47,153,284,141,425,729,289,1018,1371,631,2002,1663,1152,2815,1340,1461,2801,448,963,1411,5986,4722,10708
2021-06-10,9,9,18,4,2,6,32,27,59,108,47,155,286,143,429,731,290,1021,1372,634,2006,1668,1155,2823,1345,1464,2809,451,965,1416,6006,4736,10742
2021-06-11,9,9,18,4,2,6,32,27,59,109,48,157,287,143,430,734,291,1025,1374,635,2009,1672,1158,2830,1347,1468,2815,454,967,1421,6022,4748,10770
2021-06-12,9,9,18,5,2,7,32,27,59,109,48,157,289,146,435,736,292,1028,1374,637,2011,1674,1159,2833,1348,1471,2819,454,969,1423,6030,4760,10790
2021-06-13,9,9,18,5,2,7,32,27,59,109,48,157,292,146,438,741,292,1033,1377,639,2016,1674,1161,2835,1353,1473,2826,454,971,1425,6046,4768,10814
2021-06-14,9,9,18,5,2,7,32,27,59,110,49,159,294,146,440,743,293,1036,1380,640,2020,1678,1163,2841,1356,1477,2833,455,973,1428,6062,4779,10841
2021-06-15,9,9,18,5,2,7,32,28,60,110,49,159,295,146,441,745,293,1038,1383,641,2024,1682,1165,2847,1358,1485,2843,455,976,1431,6074,4794,10868
2021-06-16,9,9,18,5,2,7,32,28,60,110,50,160,298,146,444,746,293,1039,1385,642,2027,1685,1169,2854,1359,1486,2845,456,979,1435,6085,4804,10889
2021-06-17,9,9,18,5,2,7,33,28,61,111,50,161,298,146,444,752,296,1048,1387,644,2031,1690,1171,2861,1361,1487,2848,456,979,1435,6102,4812,10914
2021-06-18,9,9,18,5,2,7,33,28,61,111,50,161,298,146,444,752,297,1049,1392,644,2036,1695,1172,2867,1362,1490,2852,457,980,1437,6114,4818,10932
2021-06-19,9,9,18,5,2,7,33,28,61,111,50,161,300,146,446,753,300,1053,1396,645,2041,1695,1176,2871,1364,1495,2859,458,981,1439,6124,4832,10956
2021-06-20,9,9,18,5,2,7,33,28,61,111,50,161,300,146,446,755,301,1056,1399,646,2045,1697,1177,2874,1365,1496,2861,458,983,1441,6132,4838,10970
2021-06-21,9,9,18,5,2,7,33,28,61,111,51,162,300,146,446,757,303,1060,1399,647,2046,1698,1179,2877,1366,1496,2862,458,985,1443,6136,4846,10982
2021-06-22,9,9,18,5,2,7,33,29,62,111,52,163,303,146,449,760,304,1064,1400,648,2048,1701,1182,2883,1368,1498,2866,458,986,1444,6148,4856,11004
2021-06-23,9,9,18,5,2,7,33,29,62,111,52,163,304,147,451,761,304,1065,1402,651,2053,1705,1184,2889,1371,1502,2873,458,987,1445,6159,4867,11026
2021-06-24,9,9,18,5,2,7,33,29,62,112,52,164,305,147,452,764,307,1071,1405,653,2058,1706,1187,2893,1372,1505,2877,460,988,1448,6171,4879,11050
2021-06-25,9,9,18,5,2,7,33,29,62,112,52,164,307,147,454,765,307,1072,1409,654,2063,1706,1187,2893,1373,1508,2881,460,990,1450,6179,4885,11064
2021-06-26,10,9,19,5,2,7,33,29,62,113,52,165,308,147,455,770,307,1077,1412,654,2066,1708,1190,2898,1376,1511,2887,460,992,1452,6195,4893,11088
2021-06-27,10,9,19,5,2,7,33,29,62,113,52,165,310,147,457,770,307,1077,1414,655,2069,1710,1192,2902,1377,1513,2890,460,993,1453,6202,4899,11101
2021-06-28,10,9,19,5,2,7,33,29,62,113,52,165,311,147,458,771,307,1078,1417,656,2073,1713,1195,2908,1378,1515,2893,460,993,1453,6211,4905,11116
2021-06-29,10,9,19,5,2,7,33,29,62,113,52,165,312,147,459,772,308,1080,1418,657,2075,1717,1198,2915,1380,1519,2899,461,995,1456,6221,4916,11137
2021-06-30,10,9,19,5,2,7,33,29,62,114,52,166,312,147,459,772,309,1081,1419,659,2078,1719,1201,2920,1381,1520,2901,462,995,1457,6227,4923,11150
2021-07-01,10,9,19,5,2,7,33,29,62,114,52,166,313,147,460,772,310,1082,1422,659,2081,1719,1202,2921,1383,1522,2905,462,996,1458,6233,4928,11161
2021-07-02,10,9,19,5,2,7,33,29,62,114,52,166,314,147,461,773,310,1083,1425,659,2084,1722,1204,2926,1384,1522,2906,462,998,1460,6242,4932,11174
2021-07-03,10,9,19,5,2,7,33,29,62,114,52,166,314,147,461,775,310,1085,1425,659,2084,1724,1206,2930,1386,1525,2911,462,999,1461,6248,4938,11186
2021-07-04,10,9,19,5,2,7,33,29,62,114,52,166,314,147,461,777,310,1087,1426,659,2085,1726,1206,2932,1386,1526,2912,462,1000,1462,6253,4940,11193
2021-07-05,10,9,19,5,2,7,33,29,62,114,52,166,315,148,463,778,311,1089,1428,660,2088,1727,1207,2934,1387,1527,2914,464,1000,1464,6261,4945,11206
2021-07-06,10,9,19,5,2,7,34,29,63,114,52,166,315,148,463,779,312,1091,1429,660,2089,1728,1211,2939,1391,1528,2919,465,1001,1466,6270,4952,11222
2021-07-07,10,9,19,5,2,7,34,29,63,114,52,166,315,148,463,783,312,1095,1430,660,2090,1730,1214,2944,1393,1528,2921,466,1001,1467,6280,4955,11235
2021-07-08,10,9,19,5,2,7,34,29,63,115,52,167,316,148,464,784,312,1096,1430,662,2092,1734,1215,2949,1394,1530,2924,466,1002,1468,6288,4961,11249
2021-07-09,10,9,19,5,2,7,34,29,63,115,52,167,316,148,464,784,312,1096,1430,662,2092,1734,1215,2949,1396,1530,2926,466,1002,1468,6290,4961,11251
2021-07-10,10,9,19,5,2,7,34,29,63,116,52,168,316,149,465,784,312,1096,1430,662,2092,1734,1217,2951,1398,1531,2929,467,1004,1471,6294,4967,11261
2021-07-11,10,9,19,5,2,7,34,29,63,116,52,168,316,149,465,784,313,1097,1433,662,2095,1735,1217,2952,1399,1532,2931,467,1004,1471,6299,4969,11268
2021-07-12,10,9,19,5,2,7,34,29,63,116,52,168,317,150,467,785,313,1098,1436,662,2098,1741,1217,2958,1400,1532,2932,467,1006,1473,6311,4972,11283
2021-07-13,10,9,19,5,2,7,34,29,63,117,52,169,317,151,468,786,314,1100,1440,662,2102,1745,1220,2965,1402,1535,2937,467,1006,1473,6323,4980,11303
2021-07-14,10,9,19,5,2,7,34,29,63,117,52,169,317,151,468,789,315,1104,1440,663,2103,1745,1222,2967,1402,1539,2941,467,1006,1473,6326,4988,11314
2021-07-15,10,9,19,5,2,7,34,29,63,117,52,169,317,151,468,789,316,1105,1441,663,2104,1748,1223,2971,1403,1539,2942,468,1007,1475,6332,4991,11323
2021-07-16,10,9,19,5,2,7,34,29,63,117,52,169,318,151,469,789,316,1105,1442,663,2105,1749,1223,2972,1403,1542,2945,468,1007,1475,6335,4994,11329
2021-07-17,10,9,19,5,2,7,34,29,63,117,52,169,318,151,469,792,316,1108,1443,664,2107,1750,1225,2975,1403,1543,2946,469,1007,1476,6341,4998,11339
2021-07-18,10,9,19,5,2,7,34,29,63,117,52,169,318,151,469,792,316,1108,1443,664,2107,1750,1226,2976,1406,1544,2950,469,1007,1476,6344,5000,11344
2021-07-19,11,10,21,5,2,7,35,29,64,117,52,169,318,152,470,792,316,1108,1445,664,2109,1750,1227,2977,1408,1544,2952,470,1007,1477,6351,5003,11354
2021-07-20,11,10,21,5,2,7,35,29,64,117,52,169,318,153,471,792,316,1108,1445,664,2109,1752,1228,2980,1409,1545,2954,470,1007,1477,6354,5006,11360
2021-07-21,11,10,21,5,2,7,35,29,64,117,52,169,318,153,471,793,317,1110,1445,664,2109,1754,1232,2986,1410,1545,2955,470,1007,1477,6358,5011,11369
2021-07-22,11,10,21,5,2,7,35,29,64,117,52,169,318,153,471,795,317,1112,1446,665,2111,1758,1232,2990,1410,1546,2956,470,1007,1477,6365,5013,11378
2021-07-23,11,10,21,5,2,7,35,29,64,117,52,169,319,153,472,795,318,1113,1447,666,2113,1761,1234,2995,1411,1547,2958,470,1008,1478,6371,5019,11390
2021-07-24,11,10,21,5,2,7,35,30,65,117,52,169,319,153,472,795,318,1113,1448,666,2114,1762,1234,2996,1411,1547,2958,470,1008,1478,6373,5020,11393
2021-07-25,11,10,21,5,2,7,35,30,65,117,52,169,320,153,473,796,318,1114,1448,666,2114,1763,1235,2998,1411,1547,2958,470,1009,1479,6376,5022,11398
2021-07-26,11,10,21,5,2,7,36,30,66,117,52,169,320,153,473,798,318,1116,1448,666,2114,1768,1237,3005,1412,1548,2960,470,1010,1480,6385,5026,11411
2021-07-27,11,10,21,5,2,7,37,30,67,117,52,169,320,153,473,799,319,1118,1448,666,2114,1770,1237,3007,1412,1548,2960,471,1011,1482,6390,5028,11418
2021-07-28,11,10,21,5,2,7,37,30,67,117,52,169,320,153,473,799,319,1118,1448,666,2114,1770,1237,3007,1413,1549,2962,471,1011,1482,6391,5029,11420
2021-07-29,11,10,21,5,2,7,37,30,67,117,52,169,320,153,473,800,319,1119,1448,666,2114,1770,1238,3008,1414,1550,2964,471,1011,1482,6393,5031,11424
2021-07-30,11,10,21,5,2,7,37,30,67,117,52,169,320,153,473,800,319,1119,1451,667,2118,1770,1239,3009,1414,1551,2965,471,1012,1483,6396,5035,11431
2021-07-31,11,10,21,5,2,7,37,30,67,117,52,169,320,154,474,800,319,1119,1451,667,2118,1772,1239,3011,1414,1552,2966,471,1012,1483,6398,5037,11435
2021-08-01,11,10,21,5,2,7,37,30,67,117,52,169,321,154,475,800,319,1119,1451,667,2118,1772,1239,3011,1415,1553,2968,471,1012,1483,6400,5038,11438
2021-08-02,11,10,21,5,2,7,37,30,67,117,52,169,321,154,475,800,319,1119,1452,667,2119,1772,1242,3014,1415,1557,2972,471,1012,1483,6401,5045,11446
2021-08-03,11,10,21,5,2,7,37,30,67,117,52,169,321,154,475,800,319,1119,1452,667,2119,1774,1242,3016,1416,1557,2973,471,1014,1485,6404,5047,11451
2021-08-04,11,10,21,5,2,7,37,30,67,117,52,169,322,154,476,800,319,1119,1453,667,2120,1776,1242,3018,1416,1558,2974,472,1015,1487,6409,5049,11458
2021-08-05,11,10,21,5,2,7,37,30,67,117,52,169,322,154,476,801,319,1120,1453,667,2120,1777,1244,3021,1416,1560,2976,472,1016,1488,6411,5054,11465
2021-08-06,11,10,21,5,2,7,37,30,67,117,52,169,322,154,476,801,319,1120,1454,667,2121,1778,1244,3022,1416,1560,2976,472,1016,1488,6413,5054,11467
2021-08-07,11,10,21,5,2,7,37,30,67,117,52,169,322,154,476,801,319,1120,1456,668,2124,1778,1245,3023,1416,1562,2978,472,1016,1488,6415,5058,11473
2021-08-08,11,10,21,5,2,7,37,30,67,117,52,169,322,154,476,801,319,1120,1456,668,2124,1778,1247,3025,1416,1562,2978,472,1016,1488,6415,5060,11475
2021-08-09,11,10,21,5,2,7,37,30,67,117,52,169,323,154,477,801,319,1120,1456,669,2125,1778,1249,3027,1417,1563,2980,472,1016,1488,6417,5064,11481
2021-08-10,11,10,21,5,2,7,37,30,67,117,52,169,323,154,477,802,319,1121,1456,669,2125,1778,1250,3028,1417,1563,2980,472,1016,1488,6418,5065,11483
2021-08-11,11,10,21,5,2,7,37,30,67,117,52,169,324,154,478,802,319,1121,1456,669,2125,1780,1251,3031,1417,1566,2983,472,1017,1489,6421,5070,11491
2021-08-12,11,10,21,5,2,7,37,30,67,117,52,169,324,154,478,802,319,1121,1457,670,2127,1781,1252,3033,1418,1567,2985,472,1017,1489,6424,5073,11497
2021-08-13,11,10,21,5,2,7,37,30,67,117,52,169,324,154,478,802,319,1121,1459,670,2129,1781,1253,3034,1418,1568,2986,473,1017,1490,6427,5075,11502
2021-08-14,11,10,21,5,2,7,37,30,67,117,52,169,324,154,478,802,319,1121,1459,670,2129,1784,1254,3038,1418,1568,2986,473,1017,1490,6430,5076,11506
2021-08-15,11,10,21,5,2,7,37,30,67,118,52,170,325,154,479,802,320,1122,1459,670,2129,1784,1254,3038,1418,1568,2986,474,1017,1491,6433,5077,11510
2021-08-16,11,10,21,5,2,7,37,30,67,118,52,170,325,155,480,802,320,1122,1459,670,2129,1784,1254,3038,1419,1568,2987,474,1017,1491,6434,5078,11512
2021-08-17,11,10,21,5,2,7,37,30,67,118,52,170,325,155,480,802,320,1122,1459,670,2129,1784,1255,3039,1420,1570,2990,474,1018,1492,6435,5082,11517
2021-08-18,11,10,21,5,2,7,37,30,67,118,52,170,325,155,480,802,320,1122,1459,670,2129,1784,1256,3040,1421,1571,2992,474,1018,1492,6436,5084,11520
2021-08-19,11,10,21,5,2,7,37,31,68,118,52,170,325,155,480,803,320,1123,1459,670,2129,1786,1256,3042,1422,1572,2994,474,1018,1492,6440,5086,11526
2021-08-20,11,10,21,5,2,7,37,31,68,118,52,170,325,155,480,803,320,1123,1459,670,2129,1786,1257,3043,1423,1572,2995,474,1018,1492,6441,5087,11528
2021-08-21,11,10,21,5,2,7,37,31,68,118,52,170,326,155,481,803,320,1123,1459,670,2129,1786,1257,3043,1424,1573,2997,474,1018,1492,6443,5088,11531
2021-08-22,11,10,21,5,2,7,37,31,68,118,52,170,326,155,481,803,320,1123,1459,671,2130,1786,1258,3044,1425,1573,2998,474,1019,1493,6444,5091,11535
2021-08-23,11,10,21,5,2,7,37,31,68,118,52,170,327,155,482,803,320,1123,1459,671,2130,1786,1258,3044,1426,1573,2999,475,1019,1494,6447,5091,11538
2021-08-24,11,10,21,5,2,7,37,31,68,118,52,170,327,156,483,803,320,1123,1459,671,2130,1787,1259,3046,1427,1573,3000,475,1019,1494,6449,5093,11542
2021-08-25,11,10,21,5,2,7,37,31,68,118,52,170,327,156,483,803,320,1123,1459,671,2130,1787,1259,3046,1427,1574,3001,475,1019,1494,6449,5094,11543
2021-08-26,11,10,21,5,2,7,37,31,68,118,52,170,327,156,483,803,320,1123,1460,671,2131,1787,1259,3046,1427,1574,3001,475,1020,1495,6450,5095,11545
2021-08-27,11,10,21,5,2,7,37,31,68,118,52,170,327,156,483,803,320,1123,1460,671,2131,1787,1260,3047,1427,1576,3003,475,1020,1495,6450,5098,11548
2021-08-28,11,10,21,5,2,7,37,31,68,118,52,170,327,156,483,803,320,1123,1461,671,2132,1788,1260,3048,1427,1576,3003,475,1020,1495,6452,5098,11550
2021-08-29,11,10,21,5,2,7,37,31,68,118,52,170,327,156,483,803,320,1123,1461,671,2132,1788,1262,3050,1427,1576,3003,475,1020,1495,6452,5100,11552
2021-08-30,11,10,21,5,2,7,37,31,68,118,52,170,327,156,483,803,321,1124,1462,671,2133,1788,1262,3050,1427,1576,3003,476,1020,1496,6454,5101,11555
2021-08-31,11,10,21,5,2,7,37,31,68,118,52,170,327,156,483,803,321,1124,1462,673,2135,1788,1262,3050,1428,1576,3004,476,1022,1498,6455,5105,11560
2021-09-01,11,10,21,5,2,7,37,31,68,118,53,171,327,156,483,803,321,1124,1462,673,2135,1788,1262,3050,1428,1576,3004,476,1023,1499,6455,5107,11562
2021-09-02,11,10,21,5,2,7,37,31,68,118,53,171,327,156,483,803,321,1124,1462,673,2135,1788,1262,3050,1428,1577,3005,476,1023,1499,6455,5108,11563
2021-09-03,11,10,21,5,2,7,37,31,68,118,53,171,327,156,483,804,321,1125,1462,673,2135,1788,1262,3050,1429,1577,3006,476,1023,1499,6457,5108,11565
2021-09-04,11,10,21,5,2,7,37,31,68,118,53,171,327,157,484,804,321,1125,1462,673,2135,1788,1262,3050,1429,1577,3006,476,1023,1499,6457,5109,11566
2021-09-05,11,10,21,5,2,7,37,31,68,118,53,171,328,157,485,804,321,1125,1462,673,2135,1788,1262,3050,1429,1577,3006,476,1023,1499,6458,5109,11567
2021-09-06,11,10,21,5,2,7,37,31,68,118,53,171,328,157,485,804,321,1125,1463,673,2136,1788,1262,3050,1429,1577,3006,476,1023,1499,6459,5109,11568
2021-09-07,11,10,21,5,2,7,37,31,68,118,53,171,328,157,485,804,321,1125,1463,673,2136,1789,1262,3051,1429,1577,3006,476,1023,1499,6460,5109,11569
2021-09-08,11,10,21,5,2,7,37,31,68,118,53,171,328,157,485,804,321,1125,1463,673,2136,1789,1263,3052,1429,1577,3006,476,1024,1500,6460,5111,11571
2021-09-09,11,10,21,5,2,7,37,31,68,118,53,171,328,157,485,804,321,1125,1463,673,2136,1790,1263,3053,1430,1577,3007,476,1024,1500,6462,5111,11573
2021-09-10,11,10,21,5,2,7,37,31,68,118,53,171,328,157,485,804,321,1125,1463,673,2136,1790,1263,3053,1430,1577,3007,476,1024,1500,6462,5111,11573
2021-09-11,11,10,21,5,2,7,37,31,68,118,53,171,328,157,485,804,321,1125,1463,673,2136,1790,1263,3053,1430,1577,3007,476,1024,1500,6462,5111,11573
2021-09-12,11,10,21,5,2,7,37,31,68,118,53,171,328,157,485,804,321,1125,1463,673,2136,1790,1263,3053,1430,1577,3007,476,1024,1500,6462,5111,11573
2021-09-13,11,10,21,5,2,7,37,31,68,118,53,171,328,157,485,804,321,1125,1463,673,2136,1790,1263,3053,1430,1578,3008,476,1024,1500,6462,5112,11574
2021-09-14,11,10,21,5,2,7,37,31,68,118,53,171,328,157,485,804,321,1125,1463,673,2136,1791,1263,3054,1430,1578,3008,476,1024,1500,6463,5112,11575
2021-09-15,11,10,21,5,2,7,37,31,68,119,53,172,328,157,485,804,321,1125,1463,673,2136,1791,1263,3054,1430,1578,3008,476,1024,1500,6464,5112,11576
2021-09-16,11,10,21,5,2,7,37,31,68,119,53,172,328,157,485,804,321,1125,1463,673,2136,1791,1264,3055,1430,1578,3008,476,1024,1500,6464,5113,11577
2021-09-17,11,10,21,5,2,7,37,31,68,119,53,172,328,157,485,804,321,1125,1463,673,2136,1791,1264,3055,1430,1578,3008,476,1024,1500,6464,5113,11577
2021-09-18,11,10,21,5,2,7,37,31,68,119,53,172,328,157,485,804,321,1125,1463,673,2136,1791,1264,3055,1430,1578,3008,476,1024,1500,6464,5113,11577
2021-09-19,11,10,21,5,2,7,37,31,68,119,53,172,328,157,485,804,321,1125,1463,673,2136,1791,1265,3056,1430,1578,3008,476,1024,1500,6464,5114,11578
2021-09-20,11,10,21,5,2,7,37,31,68,119,53,172,328,157,485,804,321,1125,1463,673,2136,1791,1265,3056,1430,1578,3008,476,1024,1500,6464,5114,11578
2021-09-21,11,10,21,5,2,7,37,31,68,119,53,172,328,157,485,804,321,1125,1463,673,2136,1791,1265,3056,1430,1578,3008,476,1024,1500,6464,5114,11578
2021-09-22,11,10,21,5,2,7,37,31,68,119,53,172,328,157,485,804,321,1125,1463,673,2136,1791,1265,3056,1430,1578,3008,476,1024,1500,6464,5114,11578
2021-09-23,11,10,21,5,2,7,37,31,68,119,53,172,328,157,485,804,321,1125,1464,673,2137,1791,1265,3056,1430,1578,3008,476,1024,1500,6465,5114,11579
2021-09-24,11,10,21,5,2,7,37,31,68,119,53,172,328,157,485,804,321,1125,1464,673,2137,1791,1265,3056,1431,1578,3009,476,1024,1500,6466,5114,11580
2021-09-25,11,10,21,5,2,7,37,31,68,119,53,172,328,157,485,804,321,1125,1464,673,2137,1792,1265,3057,1431,1578,3009,476,1024,1500,6467,5114,11581
2021-09-26,11,10,21,5,2,7,37,31,68,119,53,172,328,157,485,804,321,1125,1464,673,2137,1792,1265,3057,1431,1578,3009,476,1024,1500,6467,5114,11581
2021-09-27,11,10,21,5,2,7,37,31,68,119,53,172,328,157,485,804,321,1125,1464,673,2137,1792,1265,3057,1431,1578,3009,476,1024,1500,6467,5114,11581
2021-09-28,11,10,21,5,2,7,37,31,68,119,53,172,328,157,485,804,321,1125,1464,673,2137,1792,1265,3057,1431,1578,3009,476,1024,1500,6467,5114,11581
2021-09-29,11,10,21,5,2,7,37,31,68,119,53,172,328,157,485,804,321,1125,1464,673,2137,1792,1265,3057,1431,1578,3009,476,1024,1500,6467,5114,11581
2021-09-30,11,10,21,5,2,7,37,31,68,119,53,172,328,157,485,805,321,1126,1464,673,2137,1792,1265,3057,1431,1578,3009,476,1024,1500,6468,5114,11582
2021-10-01,11,10,21,5,2,7,37,31,68,119,53,172,328,157,485,805,321,1126,1464,673,2137,1792,1266,3058,1431,1578,3009,476,1024,1500,6468,5115,11583
2021-10-02,11,10,21,5,2,7,37,31,68,119,53,172,328,157,485,805,321,1126,1464,673,2137,1792,1266,3058,1431,1578,3009,476,1024,1500,6468,5115,11583
2021-10-03,11,10,21,5,2,7,37,31,68,119,53,172,328,157,485,805,321,1126,1465,673,2138,1792,1266,3058,1431,1578,3009,476,1024,1500,6469,5115,11584
2021-10-04,11,10,21,5,2,7,37,31,68,119,54,173,328,157,485,805,321,1126,1465,674,2139,1792,1266,3058,1431,1578,3009,476,1024,1500,6469,5117,11586
2021-10-05,11,10,21,5,2,7,37,31,68,119,54,173,328,157,485,805,322,1127,1465,674,2139,1792,1266,3058,1431,1578,3009,476,1024,1500,6469,5118,11587
2021-10-06,11,10,21,5,2,7,37,31,68,119,54,173,328,157,485,805,322,1127,1465,674,2139,1792,1267,3059,1431,1578,3009,476,1024,1500,6469,5119,11588
2021-10-07,11,10,21,5,2,7,37,31,68,119,54,173,328,157,485,805,322,1127,1465,674,2139,1792,1267,3059,1431,1578,3009,476,1024,1500,6469,5119,11588
2021-10-08,11,10,21,5,2,7,37,31,68,119,54,173,328,157,485,805,322,1127,1465,674,2139,1792,1267,3059,1432,1578,3010,476,1024,1500,6470,5119,11589
2021-10-09,11,10,21,5,2,7,37,31,68,119,54,173,328,157,485,805,322,1127,1465,674,2139,1792,1267,3059,1432,1578,3010,476,1024,1500,6470,5119,11589
2021-10-10,11,10,21,5,2,7,37,31,68,119,54,173,328,157,485,805,322,1127,1465,674,2139,1792,1267,3059,1432,1578,3010,476,1024,1500,6470,5119,11589
2021-10-11,11,10,21,5,2,7,37,31,68,119,54,173,328,157,485,805,322,1127,1465,674,2139,1792,1267,3059,1432,1578,3010,476,1024,1500,6470,5119,11589
2021-10-12,11,10,21,5,2,7,37,31,68,119,54,173,328,157,485,805,322,1127,1465,674,2139,1792,1268,3060,1432,1578,3010,476,1024,1500,6470,5120,11590
2021-10-13,11,10,21,5,2,7,37,31,68,119,54,173,328,157,485,805,322,1127,1465,674,2139,1792,1269,3061,1432,1578,3010,476,1024,1500,6470,5121,11591
2021-10-14,11,10,21,5,2,7,37,31,68,119,54,173,328,157,485,806,322,1128,1466,674,2140,1792,1269,3061,1432,1578,3010,476,1024,1500,6472,5121,11593
2021-10-15,11,10,21,5,2,7,37,31,68,119,54,173,328,157,485,806,322,1128,1466,674,2140,1794,1269,3063,1432,1578,3010,476,1024,1500,6474,5121,11595
2021-10-16,11,10,21,5,2,7,37,31,68,119,54,173,328,157,485,806,322,1128,1466,674,2140,1794,1269,3063,1433,1578,3011,477,1024,1501,6476,5121,11597
2021-10-17,11,10,21,5,2,7,37,31,68,119,54,173,329,157,486,806,322,1128,1466,674,2140,1794,1269,3063,1433,1578,3011,477,1024,1501,6477,5121,11598
2021-10-18,11,10,21,5,2,7,37,31,68,119,54,173,329,157,486,806,322,1128,1466,674,2140,1794,1269,3063,1433,1578,3011,477,1024,1501,6477,5121,11598
2021-10-19,11,10,21,5,2,7,37,31,68,119,54,173,329,157,486,807,322,1129,1466,674,2140,1794,1269,3063,1433,1578,3011,478,1024,1502,6479,5121,11600
2021-10-20,11,10,21,5,2,7,37,31,68,119,54,173,329,157,486,807,322,1129,1466,674,2140,1794,1269,3063,1433,1578,3011,478,1024,1502,6479,5121,11600
2021-10-21,11,10,21,5,2,7,37,31,68,119,54,173,329,157,486,807,322,1129,1466,674,2140,1794,1269,3063,1433,1578,3011,478,1024,1502,6479,5121,11600
2021-10-22,11,10,21,5,2,7,37,31,68,119,54,173,329,157,486,807,322,1129,1466,674,2140,1794,1269,3063,1433,1578,3011,479,1024,1503,6480,5121,11601
2021-10-23,11,10,21,5,2,7,37,31,68,119,54,173,329,157,486,808,322,1130,1466,674,2140,1794,1269,3063,1433,1578,3011,479,1024,1503,6481,5121,11602
2021-10-24,11,10,21,5,2,7,37,31,68,119,54,173,329,157,486,808,322,1130,1466,674,2140,1794,1269,3063,1433,1578,3011,479,1024,1503,6481,5121,11602
2021-10-25,11,10,21,5,2,7,37,31,68,119,54,173,329,157,486,809,323,1132,1466,674,2140,1794,1269,3063,1433,1579,3012,479,1024,1503,6482,5123,11605
2021-10-26,11,10,21,5,2,7,37,31,68,119,54,173,329,157,486,809,323,1132,1466,675,2141,1794,1269,3063,1433,1579,3012,479,1024,1503,6482,5124,11606
2021-10-27,11,10,21,5,2,7,37,31,68,119,54,173,329,157,486,809,323,1132,1466,675,2141,1794,1270,3064,1433,1579,3012,479,1024,1503,6482,5125,11607
2021-10-28,11,10,21,5,2,7,37,31,68,119,54,173,329,157,486,809,323,1132,1466,675,2141,1794,1270,3064,1433,1580,3013,479,1024,1503,6482,5126,11608
2021-10-29,11,10,21,5,2,7,37,31,68,119,54,173,329,157,486,809,323,1132,1466,675,2141,1794,1270,3064,1433,1580,3013,479,1024,1503,6482,5126,11608
2021-10-30,11,10,21,5,2,7,37,31,68,119,54,173,329,157,486,809,323,1132,1466,675,2141,1794,1271,3065,1433,1580,3013,479,1024,1503,6482,5127,11609
2021-10-31,11,10,21,5,2,7,37,31,68,119,54,173,329,157,486,809,323,1132,1466,675,2141,1794,1271,3065,1433,1580,3013,479,1025,1504,6482,5128,11610
2021-11-01,11,10,21,5,2,7,37,31,68,119,54,173,329,157,486,809,323,1132,1466,675,2141,1794,1271,3065,1433,1580,3013,479,1025,1504,6482,5128,11610
2021-11-02,11,10,21,5,2,7,37,31,68,119,54,173,329,157,486,809,323,1132,1466,675,2141,1794,1271,3065,1433,1580,3013,479,1025,1504,6482,5128,11610
2021-11-03,11,10,21,5,2,7,37,31,68,119,54,173,329,157,486,809,323,1132,1466,675,2141,1794,1271,3065,1433,1580,3013,479,1025,1504,6482,5128,11610
2021-11-04,11,10,21,5,2,7,37,31,68,119,54,173,329,157,486,809,323,1132,1466,675,2141,1794,1271,3065,1433,1580,3013,479,1025,1504,6482,5128,11610
2021-11-05,11,10,21,5,2,7,37,31,68,119,54,173,329,157,486,809,323,1132,1466,675,2141,1794,1271,3065,1433,1580,3013,479,1025,1504,6482,5128,11610
2021-11-06,11,10,21,5,2,7,37,31,68,119,54,173,329,157,486,810,323,1133,1466,675,2141,1794,1271,3065,1433,1580,3013,479,1025,1504,6483,5128,11611
2021-11-07,11,10,21,5,2,7,37,31,68,119,54,173,329,157,486,810,323,1133,1466,675,2141,1794,1271,3065,1433,1580,3013,479,1025,1504,6483,5128,11611
2021-11-08,11,10,21,5,2,7,37,31,68,119,54,173,329,157,486,810,323,1133,1466,675,2141,1794,1271,3065,1433,1581,3014,479,1025,1504,6483,5129,11612
2021-11-09,11,10,21,5,2,7,37,31,68,119,55,174,329,157,486,810,323,1133,1466,675,2141,1794,1271,3065,1433,1581,3014,479,1025,1504,6483,5130,11613
2021-11-10,11,10,21,5,2,7,37,31,68,119,55,174,329,157,486,810,323,1133,1466,675,2141,1794,1271,3065,1433,1581,3014,479,1025,1504,6483,5130,11613
2021-11-11,11,10,21,5,2,7,37,32,69,119,55,174,330,157,487,810,323,1133,1466,675,2141,1794,1271,3065,1433,1581,3014,479,1025,1504,6484,5131,11615
2021-11-12,11,10,21,5,2,7,37,32,69,119,55,174,330,157,487,810,323,1133,1466,675,2141,1794,1271,3065,1433,1581,3014,479,1025,1504,6484,5131,11615
2021-11-13,11,10,21,5,2,7,37,32,69,119,55,174,330,157,487,810,323,1133,1466,675,2141,1794,1271,3065,1433,1581,3014,479,1025,1504,6484,5131,11615
2021-11-14,11,10,21,5,2,7,37,32,69,119,55,174,330,157,487,810,323,1133,1466,675,2141,1794,1271,3065,1434,1581,3015,479,1025,1504,6485,5131,11616
2021-11-15,11,10,21,5,2,7,37,32,69,119,55,174,330,157,487,810,323,1133,1467,675,2142,1794,1271,3065,1435,1581,3016,479,1025,1504,6487,5131,11618
2021-11-16,11,10,21,5,2,7,37,32,69,119,55,174,330,157,487,810,323,1133,1467,675,2142,1794,1271,3065,1436,1581,3017,479,1026,1505,6488,5132,11620
2021-11-17,11,10,21,5,2,7,37,32,69,119,55,174,330,157,487,810,323,1133,1467,675,2142,1794,1271,3065,1437,1581,3018,479,1026,1505,6489,5132,11621
2021-11-18,11,10,21,5,2,7,37,32,69,119,55,174,330,157,487,810,323,1133,1467,675,2142,1794,1271,3065,1437,1581,3018,479,1026,1505,6489,5132,11621
2021-11-19,11,10,21,5,2,7,37,32,69,119,55,174,330,157,487,810,323,1133,1467,675,2142,1794,1271,3065,1437,1581,3018,479,1026,1505,6489,5132,11621
2021-11-20,11,10,21,5,2,7,37,32,69,119,55,174,330,157,487,810,323,1133,1467,675,2142,1794,1271,3065,1437,1581,3018,479,1027,1506,6489,5133,11622
2021-11-21,11,10,21,5,2,7,37,32,69,119,55,174,330,157,487,810,323,1133,1467,675,2142,1794,1271,3065,1437,1581,3018,479,1027,1506,6489,5133,11622
2021-11-22,11,10,21,5,2,7,37,32,69,119,55,174,330,157,487,810,323,1133,1467,675,2142,1794,1272,3066,1437,1581,3018,479,1027,1506,6489,5134,11623
2021-11-23,11,10,21,5,2,7,37,32,69,119,55,174,330,157,487,810,323,1133,1467,675,2142,1794,1272,3066,1437,1581,3018,479,1027,1506,6489,5134,11623
2021-11-24,11,10,21,5,2,7,37,32,69,119,55,174,330,157,487,810,323,1133,1468,675,2143,1794,1272,3066,1438,1581,3019,479,1028,1507,6491,5135,11626
2021-11-25,11,10,21,5,2,7,37,32,69,119,55,174,330,157,487,810,323,1133,1468,675,2143,1794,1272,3066,1438,1582,3020,479,1028,1507,6491,5136,11627
2021-11-26,11,10,21,5,2,7,37,32,69,119,55,174,330,157,487,810,323,1133,1468,675,2143,1794,1272,3066,1438,1582,3020,479,1028,1507,6491,5136,11627
2021-11-27,11,10,21,5,2,7,37,32,69,119,55,174,330,157,487,810,323,1133,1468,675,2143,1794,1272,3066,1438,1582,3020,479,1028,1507,6491,5136,11627
2021-11-28,11,10,21,5,2,7,37,32,69,119,55,174,330,157,487,810,323,1133,1468,675,2143,1794,1272,3066,1438,1582,3020,479,1028,1507,6491,5136,11627
2021-11-29,11,10,21,5,2,7,37,32,69,119,55,174,330,157,487,810,323,1133,1469,675,2144,1794,1272,3066,1438,1582,3020,479,1028,1507,6492,5136,11628
2021-11-30,11,10,21,5,2,7,37,32,69,119,55,174,330,157,487,810,323,1133,1470,675,2145,1794,1272,3066,1438,1582,3020,479,1028,1507,6493,5136,11629
2021-12-01,11,10,21,5,2,7,37,32,69,119,55,174,330,157,487,810,323,1133,1470,675,2145,1794,1272,3066,1438,1583,3021,479,1029,1508,6493,5138,11631
2021-12-02,11,10,21,5,2,7,37,32,69,119,55,174,330,157,487,810,323,1133,1470,675,2145,1794,1272,3066,1439,1583,3022,479,1030,1509,6494,5139,11633
2021-12-03,11,10,21,5,2,7,37,32,69,119,55,174,331,157,488,810,323,1133,1470,675,2145,1795,1272,3067,1439,1583,3022,479,1030,1509,6496,5139,11635
2021-12-04,11,10,21,5,2,7,37,32,69,119,55,174,331,157,488,810,323,1133,1470,675,2145,1796,1272,3068,1439,1584,3023,479,1030,1509,6497,5140,11637
2021-12-05,11,10,21,5,2,7,37,32,69,119,55,174,331,157,488,811,323,1134,1470,675,2145,1796,1273,3069,1439,1584,3023,479,1030,1509,6498,5141,11639
2021-12-06,11,10,21,5,2,7,37,32,69,119,55,174,331,157,488,811,323,1134,1470,675,2145,1796,1273,3069,1439,1584,3023,480,1030,1510,6499,5141,11640
2021-12-07,11,10,21,5,2,7,37,32,69,119,55,174,331,157,488,811,323,1134,1470,675,2145,1796,1273,3069,1439,1586,3025,480,1030,1510,6499,5143,11642
2021-12-08,11,10,21,5,2,7,37,32,69,120,55,175,331,157,488,811,323,1134,1471,675,2146,1796,1274,3070,1439,1586,3025,480,1030,1510,6501,5144,11645
2021-12-09,11,10,21,5,2,7,37,32,69,120,55,175,331,157,488,811,323,1134,1471,675,2146,1796,1275,3071,1441,1586,3027,480,1030,1510,6503,5145,11648
2021-12-10,11,10,21,5,2,7,37,32,69,120,55,175,331,157,488,811,324,1135,1471,675,2146,1796,1275,3071,1441,1587,3028,480,1030,1510,6503,5147,11650
2021-12-11,11,10,21,5,2,7,37,32,69,120,55,175,331,157,488,811,324,1135,1471,675,2146,1796,1275,3071,1441,1587,3028,480,1030,1510,6503,5147,11650
2021-12-12,11,10,21,5,2,7,37,32,69,120,55,175,331,157,488,811,324,1135,1471,675,2146,1796,1275,3071,1441,1587,3028,480,1030,1510,6503,5147,11650
2021-12-13,11,10,21,5,2,7,37,32,69,120,55,175,331,157,488,811,324,1135,1472,675,2147,1797,1275,3072,1441,1588,3029,480,1030,1510,6505,5148,11653
2021-12-14,11,10,21,5,2,7,37,32,69,120,55,175,331,157,488,811,324,1135,1472,675,2147,1797,1275,3072,1441,1589,3030,480,1030,1510,6505,5149,11654
2021-12-15,11,10,21,5,2,7,38,32,70,120,55,175,331,157,488,811,324,1135,1472,675,2147,1797,1275,3072,1441,1590,3031,480,1030,1510,6506,5150,11656
2021-12-16,11,10,21,5,2,7,38,32,70,120,55,175,331,157,488,811,324,1135,1472,676,2148,1797,1276,3073,1442,1590,3032,480,1030,1510,6507,5152,11659
2021-12-17,11,10,21,5,2,7,38,32,70,120,55,175,331,157,488,811,324,1135,1472,677,2149,1798,1276,3074,1442,1590,3032,481,1030,1511,6509,5153,11662
2021-12-18,11,10,21,5,2,7,38,32,70,120,55,175,331,157,488,811,324,1135,1472,677,2149,1798,1276,3074,1443,1590,3033,481,1031,1512,6510,5154,11664
2021-12-19,11,10,21,5,2,7,38,32,70,120,55,175,331,157,488,811,324,1135,1472,677,2149,1798,1277,3075,1443,1590,3033,481,1031,1512,6510,5155,11665
2021-12-20,11,10,21,5,2,7,38,32,70,120,56,176,331,157,488,811,324,1135,1472,677,2149,1799,1277,3076,1446,1591,3037,481,1031,1512,6514,5157,11671
2021-12-21,11,10,21,5,2,7,38,32,70,120,56,176,331,157,488,811,324,1135,1472,677,2149,1801,1277,3078,1447,1591,3038,483,1032,1515,6519,5158,11677
2021-12-22,11,10,21,5,2,7,38,32,70,120,56,176,331,157,488,811,324,1135,1473,677,2150,1801,1277,3078,1447,1591,3038,483,1032,1515,6520,5158,11678
2021-12-23,11,10,21,5,2,7,38,32,70,120,56,176,331,157,488,812,324,1136,1473,677,2150,1804,1277,3081,1447,1591,3038,483,1032,1515,6524,5158,11682
2021-12-24,11,10,21,5,2,7,39,32,71,120,56,176,331,157,488,813,324,1137,1474,677,2151,1804,1277,3081,1448,1591,3039,483,1033,1516,6528,5159,11687
2021-12-25,11,10,21,5,2,7,39,32,71,120,56,176,331,157,488,814,324,1138,1474,677,2151,1804,1277,3081,1448,1591,3039,483,1034,1517,6529,5160,11689
2021-12-26,11,10,21,5,2,7,39,32,71,120,56,176,331,157,488,815,324,1139,1474,677,2151,1804,1277,3081,1449,1593,3042,483,1034,1517,6531,5162,11693
2021-12-27,11,10,21,5,2,7,39,32,71,121,56,177,331,157,488,815,325,1140,1474,678,2152,1806,1278,3084,1449,1594,3043,483,1034,1517,6534,5166,11700
2021-12-28,11,10,21,5,2,7,39,32,71,121,56,177,331,157,488,815,326,1141,1474,678,2152,1807,1280,3087,1449,1598,3047,484,1035,1519,6536,5174,11710
2021-12-29,11,10,21,5,2,7,39,32,71,121,56,177,331,157,488,816,326,1142,1474,679,2153,1807,1283,3090,1449,1603,3052,484,1035,1519,6537,5183,11720
2021-12-30,11,10,21,5,2,7,39,33,72,121,56,177,331,157,488,819,327,1146,1475,680,2155,1810,1284,3094,1449,1605,3054,486,1035,1521,6546,5189,11735
2021-12-31,11,10,21,5,2,7,39,33,72,121,56,177,331,157,488,820,327,1147,1476,681,2157,1811,1284,3095,1451,1606,3057,486,1036,1522,6551,5192,11743
2022-01-01,11,10,21,5,2,7,39,33,72,121,56,177,332,157,489,821,327,1148,1477,681,2158,1811,1286,3097,1453,1606,3059,486,1037,1523,6556,5195,11751
2022-01-02,11,10,21,5,3,8,39,33,72,122,56,178,333,157,490,824,327,1151,1479,681,2160,1814,1290,3104,1454,1606,3060,486,1038,1524,6567,5201,11768
2022-01-03,11,11,22,5,4,9,39,34,73,122,56,178,334,159,493,825,328,1153,1480,682,2162,1818,1293,3111,1458,1608,3066,487,1042,1529,6579,5217,11796
2022-01-04,11,11,22,5,4,9,39,34,73,122,56,178,334,159,493,826,328,1154,1483,682,2165,1824,1295,3119,1462,1612,3074,488,1045,1533,6594,5226,11820
2022-01-05,11,11,22,5,4,9,40,34,74,122,56,178,334,159,493,826,329,1155,1486,684,2170,1826,1296,3122,1465,1613,3078,489,1046,1535,6604,5232,11836
2022-01-06,11,11,22,5,4,9,40,34,74,122,56,178,335,159,494,830,330,1160,1489,686,2175,1826,1301,3127,1468,1619,3087,490,1047,1537,6616,5247,11863
2022-01-07,11,11,22,5,4,9,40,34,74,122,56,178,336,160,496,832,331,1163,1491,688,2179,1828,1303,3131,1471,1621,3092,492,1048,1540,6628,5256,11884
2022-01-08,11,11,22,5,4,9,40,34,74,122,56,178,336,160,496,833,332,1165,1492,688,2180,1829,1307,3136,1471,1622,3093,494,1050,1544,6633,5264,11897
2022-01-09,11,11,22,5,4,9,40,34,74,122,56,178,337,160,497,836,333,1169,1494,688,2182,1831,1310,3141,1479,1625,3104,495,1052,1547,6650,5273,11923
2022-01-10,11,11,22,5,4,9,40,34,74,122,56,178,340,160,500,836,336,1172,1498,689,2187,1839,1313,3152,1484,1634,3118,496,1060,1556,6671,5297,11968
2022-01-11,11,11,22,5,4,9,40,34,74,122,56,178,340,160,500,836,339,1175,1501,691,2192,1848,1319,3167,1488,1640,3128,498,1065,1563,6689,5319,12008
2022-01-12,11,11,22,5,4,9,40,34,74,123,56,179,341,160,501,836,339,1175,1503,691,2194,1852,1327,3179,1493,1649,3142,502,1070,1572,6706,5341,12047
2022-01-13,11,11,22,5,4,9,40,34,74,123,56,179,341,162,503,836,340,1176,1506,692,2198,1855,1329,3184,1497,1655,3152,506,1082,1588,6720,5365,12085
2022-01-14,11,11,22,5,4,9,40,34,74,123,56,179,343,162,505,838,343,1181,1506,694,2200,1860,1335,3195,1512,1662,3174,509,1093,1602,6747,5394,12141
2022-01-15,11,11,22,5,4,9,40,34,74,124,56,180,343,162,505,838,344,1182,1507,696,2203,1866,1338,3204,1523,1673,3196,512,1098,1610,6769,5416,12185
2022-01-16,12,12,24,5,4,9,40,34,74,125,56,181,344,163,507,838,345,1183,1510,697,2207,1874,1342,3216,1530,1676,3206,515,1103,1618,6793,5432,12225
2022-01-17,14,13,27,6,4,10,40,34,74,125,56,181,345,163,508,838,346,1184,1514,701,2215,1882,1355,3237,1539,1686,3225,520,1110,1630,6823,5468,12291
2022-01-18,14,13,27,6,4,10,40,34,74,125,56,181,348,163,511,839,348,1187,1517,702,2219,1888,1360,3248,1545,1690,3235,522,1118,1640,6844,5488,12332
2022-01-19,14,13,27,6,4,10,41,34,75,125,56,181,348,163,511,842,349,1191,1521,704,2225,1900,1364,3264,1556,1693,3249,527,1125,1652,6880,5505,12385
2022-01-20,14,13,27,6,4,10,41,34,75,125,56,181,348,164,512,842,350,1192,1529,705,2234,1904,1369,3273,1565,1699,3264,529,1134,1663,6903,5528,12431
2022-01-21,14,13,27,6,4,10,41,35,76,126,56,182,349,164,513,843,351,1194,1533,705,2238,1910,1375,3285,1570,1710,3280,530,1135,1665,6922,5548,12470
2022-01-22,14,13,27,6,4,10,41,35,76,126,56,182,349,164,513,843,351,1194,1534,708,2242,1913,1378,3291,1575,1717,3292,535,1139,1674,6936,5565,12501
2022-01-23,14,13,27,6,4,10,41,35,76,126,56,182,349,165,514,844,351,1195,1536,711,2247,1917,1379,3296,1578,1724,3302,536,1141,1677,6947,5579,12526
2022-01-24,14,13,27,7,4,11,41,35,76,126,57,183,350,166,516,846,351,1197,1538,715,2253,1927,1381,3308,1581,1729,3310,537,1146,1683,6967,5597,12564
2022-01-25,14,13,27,7,4,11,41,35,76,126,57,183,350,166,516,848,352,1200,1543,716,2259,1931,1384,3315,1586,1741,3327,538,1153,1691,6984,5621,12605
2022-01-26,14,13,27,7,4,11,42,35,77,127,57,184,350,166,516,850,354,1204,1546,716,2262,1934,1386,3320,1592,1748,3340,544,1156,1700,7006,5635,12641
2022-01-27,14,13,27,7,4,11,42,35,77,128,57,185,350,166,516,851,354,1205,1547,718,2265,1936,1389,3325,1594,1750,3344,547,1159,1706,7016,5645,12661
2022-01-28,14,13,27,7,4,11,42,35,77,128,57,185,350,166,516,852,354,1206,1550,719,2269,1940,1390,3330,1599,1754,3353,548,1160,1708,7030,5652,12682
2022-01-29,14,13,27,7,4,11,42,35,77,128,57,185,351,166,517,852,355,1207,1551,719,2270,1941,1392,3333,1600,1756,3356,548,1162,1710,7034,5659,12693
2022-01-30,14,13,27,7,4,11,42,35,77,129,57,186,352,166,518,853,355,1208,1553,719,2272,1947,1393,3340,1605,1760,3365,549,1164,1713,7051,5666,12717
2022-01-31,14,13,27,7,4,11,42,35,77,129,57,186,352,166,518,853,355,1208,1555,720,2275,1949,1396,3345,1610,1764,3374,551,1164,1715,7062,5674,12736
2022-02-01,14,13,27,7,4,11,42,36,78,129,58,187,353,166,519,853,356,1209,1557,720,2277,1952,1399,3351,1616,1769,3385,551,1167,1718,7074,5688,12762
2022-02-02,14,13,27,7,4,11,42,36,78,129,58,187,353,167,520,853,356,1209,1558,721,2279,1955,1403,3358,1619,1776,3395,551,1167,1718,7081,5701,12782
2022-02-03,14,13,27,7,4,11,42,36,78,129,58,187,353,168,521,853,356,1209,1560,722,2282,1957,1404,3361,1624,1781,3405,552,1169,1721,7091,5711,12802
2022-02-04,14,13,27,7,4,11,42,36,78,129,58,187,353,168,521,853,356,1209,1561,722,2283,1959,1405,3364,1627,1784,3411,553,1171,1724,7098,5717,12815
2022-02-05,14,13,27,7,4,11,42,36,78,129,58,187,353,168,521,853,356,1209,1561,722,2283,1961,1407,3368,1630,1787,3417,555,1171,1726,7105,5722,12827
2022-02-06,14,13,27,8,4,12,42,36,78,129,58,187,353,168,521,854,356,1210,1561,722,2283,1962,1409,3371,1632,1788,3420,557,1172,1729,7112,5726,12838
2022-02-07,14,13,27,8,4,12,42,36,78,129,58,187,354,168,522,855,356,1211,1562,722,2284,1963,1410,3373,1633,1792,3425,558,1174,1732,7118,5733,12851
2022-02-08,14,13,27,8,4,12,42,36,78,129,58,187,354,168,522,855,357,1212,1562,722,2284,1963,1412,3375,1635,1795,3430,559,1174,1733,7121,5739,12860
2022-02-09,14,13,27,8,4,12,42,36,78,129,58,187,354,168,522,856,358,1214,1562,723,2285,1964,1412,3376,1635,1796,3431,559,1174,1733,7123,5742,12865
2022-02-10,14,13,27,8,4,12,42,36,78,129,58,187,355,168,523,856,358,1214,1563,725,2288,1969,1413,3382,1635,1799,3434,559,1174,1733,7130,5748,12878
2022-02-11,14,13,27,8,4,12,42,36,78,129,58,187,355,168,523,857,358,1215,1563,725,2288,1970,1413,3383,1635,1802,3437,559,1175,1734,7132,5752,12884
2022-02-12,14,13,27,8,4,12,42,36,78,129,58,187,355,168,523,857,358,1215,1563,725,2288,1970,1413,3383,1637,1802,3439,559,1175,1734,7134,5752,12886
2022-02-13,14,13,27,8,4,12,42,36,78,129,58,187,355,168,523,857,358,1215,1563,725,2288,1970,1413,3383,1638,1802,3440,559,1176,1735,7135,5753,12888
2022-02-14,14,13,27,8,4,12,42,36,78,129,58,187,355,168,523,857,358,1215,1563,725,2288,1972,1413,3385,1639,1806,3445,559,1177,1736,7138,5758,12896
2022-02-15,14,13,27,8,4,12,42,36,78,129,58,187,355,168,523,857,358,1215,1563,726,2289,1973,1414,3387,1641,1809,3450,559,1178,1737,7141,5764,12905
2022-02-16,14,13,27,8,4,12,42,36,78,129,58,187,355,168,523,857,358,1215,1564,726,2290,1973,1415,3388,1641,1811,3452,559,1179,1738,7142,5768,12910
2022-02-17,14,13,27,8,4,12,42,36,78,129,58,187,355,168,523,857,358,1215,1564,727,2291,1974,1415,3389,1641,1813,3454,560,1179,1739,7144,5771,12915
2022-02-18,14,13,27,8,4,12,42,36,78,129,58,187,355,168,523,857,358,1215,1564,727,2291,1974,1417,3391,1642,1814,3456,560,1179,1739,7145,5774,12919
2022-02-19,14,13,27,8,4,12,42,36,78,129,58,187,355,168,523,857,358,1215,1564,727,2291,1974,1419,3393,1643,1815,3458,560,1180,1740,7146,5778,12924
2022-02-20,14,13,27,8,4,12,42,36,78,129,58,187,355,168,523,857,358,1215,1564,727,2291,1975,1419,3394,1643,1815,3458,560,1180,1740,7147,5778,12925
2022-02-21,14,13,27,8,4,12,42,36,78,129,58,187,355,168,523,857,358,1215,1565,728,2293,1976,1419,3395,1643,1817,3460,560,1180,1740,7149,5781,12930
2022-02-22,14,13,27,8,4,12,42,36,78,129,58,187,355,168,523,857,358,1215,1565,728,2293,1976,1420,3396,1643,1817,3460,561,1180,1741,7150,5782,12932
2022-02-23,14,13,27,8,4,12,42,36,78,129,58,187,355,168,523,857,358,1215,1565,728,2293,1976,1421,3397,1643,1818,3461,561,1180,1741,7150,5784,12934
2022-02-24,14,13,27,8,4,12,42,36,78,129,58,187,355,168,523,857,358,1215,1567,728,2295,1977,1421,3398,1643,1818,3461,561,1180,1741,7153,5784,12937
2022-02-25,14,13,27,8,4,12,42,36,78,129,58,187,355,168,523,857,359,1216,1567,730,2297,1977,1421,3398,1644,1818,3462,561,1180,1741,7154,5787,12941
2022-02-26,14,13,27,8,4,12,42,37,79,129,58,187,355,168,523,857,359,1216,1567,730,2297,1978,1421,3399,1644,1821,3465,561,1180,1741,7155,5791,12946
2022-02-27,14,13,27,8,4,12,42,37,79,129,58,187,355,168,523,857,359,1216,1567,730,2297,1978,1421,3399,1644,1821,3465,561,1180,1741,7155,5791,12946
2022-02-28,14,13,27,8,4,12,42,37,79,129,58,187,355,168,523,857,359,1216,1568,730,2298,1978,1421,3399,1644,1821,3465,561,1181,1742,7156,5792,12948
2022-03-01,14,13,27,8,4,12,42,37,79,130,58,188,355,168,523,857,359,1216,1568,730,2298,1979,1421,3400,1644,1822,3466,561,1181,1742,7158,5793,12951
2022-03-02,14,13,27,8,4,12,42,37,79,130,58,188,355,168,523,857,360,1217,1568,731,2299,1979,1421,3400,1645,1822,3467,561,1181,1742,7159,5795,12954
2022-03-03,14,13,27,8,4,12,42,37,79,130,58,188,355,168,523,857,360,1217,1568,731,2299,1979,1421,3400,1645,1823,3468,561,1183,1744,7159,5798,12957
2022-03-04,14,13,27,8,4,12,42,37,79,130,58,188,355,168,523,857,360,1217,1568,731,2299,1979,1421,3400,1645,1823,3468,561,1183,1744,7159,5798,12957
2022-03-05,14,13,27,8,4,12,42,37,79,130,58,188,355,168,523,857,360,1217,1568,731,2299,1979,1421,3400,1645,1823,3468,561,1183,1744,7159,5798,12957
2022-03-06,14,13,27,8,4,12,42,37,79,130,58,188,355,168,523,857,360,1217,1568,731,2299,1979,1421,3400,1645,1823,3468,561,1183,1744,7159,5798,12957
2022-03-07,14,13,27,8,4,12,42,37,79,130,58,188,355,168,523,857,360,1217,1568,732,2300,1979,1421,3400,1645,1823,3468,561,1184,1745,7159,5800,12959
2022-03-08,14,13,27,8,4,12,42,37,79,130,58,188,355,168,523,857,360,1217,1569,732,2301,1980,1421,3401,1645,1823,3468,561,1184,1745,7161,5800,12961
2022-03-09,14,13,27,8,4,12,42,37,79,130,58,188,355,168,523,857,360,1217,1569,732,2301,1980,1421,3401,1646,1823,3469,561,1184,1745,7162,5800,12962
2022-03-10,14,13,27,8,4,12,42,37,79,130,58,188,355,168,523,857,360,1217,1569,732,2301,1980,1421,3401,1646,1823,3469,561,1184,1745,7162,5800,12962
2022-03-11,14,13,27,8,4,12,42,37,79,130,58,188,355,168,523,857,360,1217,1569,732,2301,1981,1421,3402,1646,1823,3469,561,1184,1745,7163,5800,12963
2022-03-12,14,13,27,8,4,12,42,37,79,130,58,188,355,168,523,857,360,1217,1569,732,2301,1981,1421,3402,1646,1823,3469,561,1184,1745,7163,5800,12963
2022-03-13,14,13,27,8,4,12,42,37,79,130,58,188,355,168,523,857,360,1217,1569,732,2301,1981,1421,3402,1646,1823,3469,561,1184,1745,7163,5800,12963
2022-03-14,14,13,27,8,4,12,42,37,79,130,58,188,355,168,523,857,360,1217,1569,732,2301,1981,1422,3403,1646,1823,3469,561,1184,1745,7163,5801,12964
2022-03-15,14,13,27,8,4,12,42,37,79,130,58,188,355,168,523,857,360,1217,1569,732,2301,1981,1422,3403,1647,1823,3470,562,1184,1746,7165,5801,12966
2022-03-16,14,13,27,8,4,12,42,37,79,130,58,188,355,168,523,857,360,1217,1569,732,2301,1981,1422,3403,1648,1823,3471,562,1186,1748,7166,5803,12969
2022-03-17,14,13,27,8,4,12,42,37,79,130,58,188,355,168,523,857,360,1217,1569,732,2301,1981,1423,3404,1648,1823,3471,562,1186,1748,7166,5804,12970
2022-03-18,14,13,27,8,4,12,42,37,79,130,58,188,355,168,523,857,360,1217,1569,732,2301,1981,1423,3404,1648,1823,3471,562,1187,1749,7166,5805,12971
2022-03-19,14,13,27,8,4,12,42,37,79,130,58,188,355,168,523,857,360,1217,1569,732,2301,1981,1423,3404,1648,1823,3471,562,1187,1749,7166,5805,12971
2022-03-20,14,13,27,8,4,12,42,37,79,130,58,188,355,168,523,857,360,1217,1569,732,2301,1981,1423,3404,1648,1823,3471,562,1187,1749,7166,5805,12971
2022-03-21,14,13,27,8,4,12,42,37,79,130,58,188,355,168,523,857,360,1217,1569,732,2301,1981,1423,3404,1648,1823,3471,562,1187,1749,7166,5805,12971
2022-03-22,14,13,27,8,4,12,42,37,79,130,58,188,355,168,523,857,360,1217,1569,732,2301,1981,1423,3404,1648,1824,3472,562,1187,1749,7166,5806,12972
2022-03-23,14,13,27,8,4,12,42,37,79,130,58,188,355,168,523,857,360,1217,1569,732,2301,1981,1423,3404,1648,1824,3472,562,1187,1749,7166,5806,12972
2022-03-24,14,13,27,8,4,12,42,37,79,130,58,188,355,168,523,857,360,1217,1569,732,2301,1981,1423,3404,1648,1824,3472,562,1187,1749,7166,5806,12972
2022-03-25,14,13,27,8,4,12,42,37,79,130,58,188,355,168,523,857,360,1217,1569,732,2301,1981,1423,3404,1648,1824,3472,562,1187,1749,7166,5806,12972
2022-03-26,14,13,27,8,4,12,42,37,79,130,58,188,355,168,523,857,360,1217,1569,732,2301,1981,1423,3404,1648,1825,3473,562,1187,1749,7166,5807,12973
2022-03-27,14,13,27,8,4,12,42,37,79,130,58,188,355,168,523,857,360,1217,1569,732,2301,1981,1423,3404,1648,1825,3473,562,1187,1749,7166,5807,12973
2022-03-28,14,13,27,8,4,12,42,37,79,130,58,188,355,168,523,857,360,1217,1569,732,2301,1981,1423,3404,1648,1826,3474,562,1188,1750,7166,5809,12975
2022-03-29,14,13,27,8,4,12,42,37,79,130,58,188,355,168,523,857,360,1217,1569,733,2302,1981,1423,3404,1648,1826,3474,562,1188,1750,7166,5810,12976
2022-03-30,14,13,27,8,4,12,42,37,79,130,58,188,355,168,523,857,360,1217,1569,733,2302,1982,1423,3405,1648,1826,3474,562,1188,1750,7167,5810,12977
2022-03-31,14,13,27,8,4,12,42,37,79,130,58,188,356,168,524,857,360,1217,1569,733,2302,1983,1423,3406,1648,1826,3474,562,1188,1750,7169,5810,12979
2022-04-01,14,13,27,8,4,12,42,37,79,130,58,188,356,168,524,857,360,1217,1570,733,2303,1983,1423,3406,1648,1826,3474,562,1189,1751,7170,5811,12981
2022-04-02,14,13,27,8,4,12,42,37,79,130,58,188,356,168,524,857,360,1217,1570,733,2303,1983,1423,3406,1648,1826,3474,562,1189,1751,7170,5811,12981
2022-04-03,14,13,27,8,4,12,42,37,79,130,58,188,356,168,524,857,360,1217,1570,733,2303,1983,1424,3407,1648,1826,3474,562,1189,1751,7170,5812,12982
2022-04-04,14,13,27,8,4,12,42,37,79,130,58,188,356,168,524,857,360,1217,1570,733,2303,1983,1424,3407,1648,1826,3474,562,1189,1751,7170,5812,12982
2022-04-05,14,13,27,8,4,12,42,37,79,130,58,188,356,168,524,857,360,1217,1570,733,2303,1983,1424,3407,1648,1826,3474,562,1189,1751,7170,5812,12982
2022-04-06,14,13,27,8,4,12,42,37,79,130,58,188,356,168,524,857,360,1217,1571,733,2304,1983,1424,3407,1648,1827,3475,562,1189,1751,7171,5813,12984
2022-04-07,14,13,27,8,4,12,42,37,79,130,58,188,356,168,524,857,360,1217,1571,733,2304,1983,1424,3407,1649,1827,3476,562,1189,1751,7172,5813,12985
2022-04-08,14,13,27,8,4,12,42,37,79,130,58,188,356,168,524,857,360,1217,1571,733,2304,1983,1424,3407,1650,1827,3477,562,1189,1751,7173,5813,12986
2022-04-09,14,13,27,8,4,12,42,37,79,130,58,188,356,168,524,857,360,1217,1571,733,2304,1983,1424,3407,1650,1827,3477,562,1189,1751,7173,5813,12986
2022-04-10,14,13,27,8,4,12,42,37,79,130,58,188,356,168,524,857,360,1217,1571,733,2304,1983,1424,3407,1650,1827,3477,562,1190,1752,7173,5814,12987
2022-04-11,14,13,27,8,4,12,42,37,79,130,58,188,356,168,524,858,360,1218,1571,733,2304,1984,1424,3408,1650,1827,3477,562,1190,1752,7175,5814,12989
2022-04-12,14,13,27,8,4,12,42,37,79,130,58,188,356,168,524,858,360,1218,1571,733,2304,1984,1424,3408,1650,1828,3478,562,1190,1752,7175,5815,12990
2022-04-13,14,13,27,8,4,12,42,37,79,130,58,188,356,168,524,858,360,1218,1571,733,2304,1984,1424,3408,1650,1828,3478,562,1190,1752,7175,5815,12990
2022-04-14,14,13,27,8,4,12,42,37,79,130,58,188,356,168,524,858,360,1218,1571,733,2304,1984,1424,3408,1650,1828,3478,562,1190,1752,7175,5815,12990
2022-04-15,14,13,27,8,4,12,42,37,79,130,58,188,356,168,524,858,360,1218,1571,733,2304,1984,1424,3408,1650,1828,3478,562,1190,1752,7175,5815,12990
2022-04-16,14,13,27,8,4,12,42,37,79,130,58,188,356,168,524,858,360,1218,1571,733,2304,1984,1424,3408,1650,1828,3478,562,1190,1752,7175,5815,12990
2022-04-17,14,13,27,8,4,12,42,37,79,130,58,188,356,168,524,858,360,1218,1571,733,2304,1984,1424,3408,1650,1828,3478,562,1190,1752,7175,5815,12990
2022-04-18,14,13,27,8,4,12,42,37,79,130,58,188,356,168,524,858,360,1218,1571,733,2304,1984,1424,3408,1650,1828,3478,562,1190,1752,7175,5815,12990
2022-04-19,14,13,27,8,4,12,42,37,79,130,58,188,356,168,524,858,360,1218,1571,733,2304,1984,1424,3408,1650,1828,3478,562,1190,1752,7175,5815,12990
2022-04-20,14,13,27,8,4,12,42,37,79,130,58,188,356,168,524,858,360,1218,1571,733,2304,1984,1424,3408,1650,1828,3478,562,1190,1752,7175,5815,12990
2022-04-21,14,13,27,8,4,12,42,37,79,130,58,188,356,168,524,859,360,1219,1572,733,2305,1984,1424,3408,1650,1828,3478,562,1190,1752,7177,5815,12992
2022-04-22,14,13,27,8,4,12,42,37,79,130,58,188,356,168,524,859,360,1219,1572,733,2305,1984,1424,3408,1651,1828,3479,562,1190,1752,7178,5815,12993
2022-04-23,14,13,27,8,4,12,42,37,79,130,58,188,356,168,524,859,360,1219,1572,733,2305,1984,1424,3408,1651,1828,3479,562,1190,1752,7178,5815,12993
2022-04-24,14,13,27,8,4,12,42,37,79,130,58,188,356,168,524,859,361,1220,1572,733,2305,1984,1424,3408,1651,1828,3479,562,1190,1752,7178,5816,12994
2022-04-25,14,13,27,8,4,12,42,37,79,131,58,189,356,168,524,859,361,1220,1572,733,2305,1984,1424,3408,1651,1828,3479,562,1190,1752,7179,5816,12995
2022-04-26,14,13,27,8,4,12,42,37,79,131,58,189,356,168,524,859,361,1220,1572,733,2305,1984,1424,3408,1651,1828,3479,562,1190,1752,7179,5816,12995
2022-04-27,14,13,27,8,4,12,42,37,79,131,58,189,356,168,524,859,361,1220,1572,733,2305,1984,1424,3408,1651,1828,3479,562,1190,1752,7179,5816,12995
2022-04-28,14,13,27,8,4,12,42,37,79,131,58,189,356,168,524,859,361,1220,1572,733,2305,1984,1424,3408,1651,1828,3479,563,1190,1753,7180,5816,12996
2022-04-29,14,13,27,8,4,12,42,37,79,131,58,189,356,168,524,859,361,1220,1572,733,2305,1984,1424,3408,1651,1828,3479,563,1190,1753,7180,5816,12996
2022-04-30,14,13,27,8,4,12,42,37,79,131,58,189,356,168,524,859,361,1220,1572,733,2305,1984,1424,3408,1651,1828,3479,563,1190,1753,7180,5816,12996
2022-05-01,14,13,27,8,4,12,42,37,79,131,58,189,356,168,524,859,361,1220,1572,733,2305,1984,1424,3408,1651,1828,3479,563,1190,1753,7180,5816,12996
2022-05-02,14,13,27,8,4,12,42,37,79,131,58,189,356,168,524,859,361,1220,1572,733,2305,1984,1424,3408,1651,1828,3479,563,1190,1753,7180,5816,12996
2022-05-03,14,13,27,8,4,12,42,37,79,131,58,189,356,168,524,859,361,1220,1572,733,2305,1984,1424,3408,1651,1829,3480,563,1190,1753,7180,5817,12997
2022-05-04,14,13,27,8,4,12,42,37,79,131,58,189,356,168,524,859,361,1220,1572,733,2305,1984,1424,3408,1651,1829,3480,563,1190,1753,7180,5817,12997
2022-05-05,14,13,27,8,4,12,42,37,79,131,58,189,356,168,524,859,361,1220,1572,733,2305,1984,1424,3408,1651,1829,3480,563,1190,1753,7180,5817,12997
2022-05-06,14,13,27,8,4,12,42,37,79,131,58,189,356,168,524,859,361,1220,1572,733,2305,1985,1424,3409,1651,1829,3480,563,1190,1753,7181,5817,12998
2022-05-07,14,13,27,8,4,12,42,37,79,131,58,189,356,168,524,859,361,1220,1572,733,2305,1985,1424,3409,1651,1829,3480,563,1190,1753,7181,5817,12998
2022-05-08,14,13,27,8,4,12,42,37,79,131,58,189,356,168,524,859,361,1220,1572,733,2305,1985,1424,3409,1652,1829,3481,563,1190,1753,7182,5817,12999
2022-05-09,14,13,27,8,4,12,42,37,79,131,58,189,356,168,524,859,361,1220,1572,734,2306,1985,1424,3409,1652,1830,3482,563,1190,1753,7182,5819,13001
2022-05-10,14,13,27,8,4,12,42,37,79,131,58,189,356,168,524,859,361,1220,1572,734,2306,1985,1424,3409,1653,1830,3483,563,1190,1753,7183,5819,13002
2022-05-11,14,13,27,8,4,12,42,37,79,131,58,189,356,168,524,859,361,1220,1572,734,2306,1985,1426,3411,1653,1830,3483,563,1190,1753,7183,5821,13004
2022-05-12,14,13,27,8,4,12,42,37,79,131,58,189,356,168,524,859,361,1220,1572,734,2306,1985,1427,3412,1654,1830,3484,563,1190,1753,7184,5822,13006
2022-05-13,14,13,27,8,4,12,42,37,79,131,58,189,356,168,524,859,361,1220,1572,734,2306,1985,1427,3412,1654,1830,3484,563,1190,1753,7184,5822,13006
2022-05-14,14,13,27,8,4,12,42,37,79,131,58,189,356,168,524,859,361,1220,1572,734,2306,1985,1427,3412,1654,1830,3484,563,1190,1753,7184,5822,13006
2022-05-15,14,13,27,8,4,12,42,37,79,131,58,189,356,168,524,859,361,1220,1572,734,2306,1985,1427,3412,1654,1830,3484,563,1190,1753,7184,5822,13006
2022-05-16,14,13,27,8,4,12,42,37,79,131,58,189,356,168,524,859,361,1220,1572,734,2306,1985,1428,3413,1654,1831,3485,563,1190,1753,7184,5824,13008
2022-05-17,14,13,27,8,4,12,42,37,79,131,58,189,356,168,524,859,361,1220,1572,734,2306,1985,1428,3413,1654,1831,3485,563,1190,1753,7184,5824,13008
2022-05-18,14,13,27,8,4,12,42,37,79,131,58,189,356,168,524,859,361,1220,1572,734,2306,1985,1428,3413,1654,1831,3485,563,1190,1753,7184,5824,13008
2022-05-19,14,13,27,8,4,12,42,37,79,131,58,189,356,168,524,859,361,1220,1572,734,2306,1985,1428,3413,1655,1831,3486,563,1190,1753,7185,5824,13009
2022-05-20,14,13,27,8,4,12,42,37,79,131,58,189,356,168,524,859,361,1220,1572,734,2306,1985,1428,3413,1655,1831,3486,563,1190,1753,7185,5824,13009
2022-05-21,14,13,27,8,4,12,42,37,79,131,58,189,356,168,524,859,361,1220,1572,734,2306,1985,1428,3413,1655,1831,3486,563,1190,1753,7185,5824,13009
